Cargo	Cargo.classification	N	Carriers
abiotrophia defectiva	Bacteria	1	homo sapiens
acanthamoeba astronyxis	Protozoa	1	homo sapiens
acanthamoeba castellanii	Protozoa	1	homo sapiens
acanthamoeba culbertsoni	Protozoa	1	homo sapiens
acanthamoeba hatchetti	Protozoa	1	homo sapiens
acanthamoeba lenticulata	Protozoa	1	homo sapiens
acanthamoeba polyphaga	Protozoa	1	homo sapiens
achromobacter denitrificans	Bacteria	2	achromobacter xylosoxidans; homo sapiens
achromobacter piechaudii	Bacteria	4	glomus intraradices; homo sapiens; nepenthes mirabilis; thorectes lusitanicus
achromobacter xylosoxidans	Bacteria	14	brassica rapa; bursaphelenchus mucronatus; clitoria ternatea; glomus intraradices; hedera helix; homo sapiens; larimichthys crocea; porphyra yezoensis; prosopis juliflora; prosopis strombulifera; solenopsis invicta; turdus merula; vigna mungo; zea mays
acidaminococcus fermentans	Bacteria	2	capra hircus; homo sapiens
acinetobacter baumannii	Bacteria	10	bos taurus; capsicum annuum; centella asiatica; culex quinquefasciatus; equus caballus; homo sapiens; ictalurus punctatus; musa acuminata; scylla paramamosain; zea mays
acinetobacter berezinae	Bacteria	1	homo sapiens
acinetobacter calcoaceticus	Bacteria	16	apis mellifera; avena sativa; betula pendula; culex quinquefasciatus; gynura procumbens; helicoverpa armigera; homo sapiens; lantana camara; musca domestica; phaseolus vulgaris; plantago lanceolata; plectranthus barbatus; solanum nigrum; sorbus aucuparia; turbo kenwilliamsi; zingiber officinale
acinetobacter haemolyticus	Bacteria	5	anopheles stephensi; homo sapiens; leptinotarsa decemlineata; musca domestica; phaseolus vulgaris
acinetobacter johnsonii	Bacteria	8	anopheles stephensi; beta vulgaris; homo sapiens; populus euphratica; takifugu rubripes; taxus globosa; tectona grandis; ulva rigida
acinetobacter junii	Bacteria	12	acipenser schrenckii; apocynum venetum; culex quinquefasciatus; cyprinus carpio; homo sapiens; ictalurus punctatus; kareius bicoloratus; nicotiana attenuata; oreochromis niloticus; pandora neoaphidis; pandora nouryi; ulva rigida
acinetobacter lwoffii	Bacteria	13	anopheles stephensi; culex quinquefasciatus; dendroctonus rhizophagus; dendroctonus valens; echinacea angustifolia; homo sapiens; moschus berezovskii; musa acuminata; populus euphratica; takifugu rubripes; taxus globosa; ulva australis; zea mays
acinetobacter parvus	Bacteria	1	homo sapiens
acinetobacter radioresistens	Bacteria	5	anopheles stephensi; culex quinquefasciatus; elaeis guineensis; homo sapiens; phaseolus vulgaris
acinetobacter septicus	Bacteria	1	homo sapiens
acinetobacter ursingii	Bacteria	2	homo sapiens; labeo rohita
acremonium strictum	Fungi	6	canis lupus; canis lupus familiaris; diabrotica virgifera; helicoverpa armigera; homo sapiens; ostrinia nubilalis
acrophialophora fusispora	Fungi	1	homo sapiens
actinobacillus hominis	Bacteria	1	homo sapiens
actinobacillus lignieresii	Bacteria	3	bos taurus; homo sapiens; ovis aries
actinobacillus pleuropneumoniae	Bacteria	7	bos taurus; canis lupus familiaris; equus caballus; homo sapiens; ovis aries; sus scrofa; sus scrofa domesticus
actinobacillus suis	Bacteria	4	equus caballus; homo sapiens; sus scrofa; sus scrofa domesticus
actinobacillus ureae	Bacteria	1	homo sapiens
actinobaculum schaalii	Bacteria	1	homo sapiens
actinomadura madurae	Fungi	1	homo sapiens
actinomadura meyerae	Bacteria	1	homo sapiens
actinomadura pelletieri	Bacteria	1	homo sapiens
actinomucor elegans	Fungi	2	homo sapiens; philanthus triangulum
actinomyces cardiffensis	Bacteria	1	homo sapiens
actinomyces dentalis	Bacteria	1	homo sapiens
actinomyces denticolens	Bacteria	1	homo sapiens
actinomyces funkei	Bacteria	1	homo sapiens
actinomyces georgiae	Bacteria	1	homo sapiens
actinomyces gerencseriae	Bacteria	1	homo sapiens
actinomyces graevenitzii	Bacteria	1	homo sapiens
actinomyces israelii	Bacteria	1	homo sapiens
actinomyces massiliensis	Bacteria	1	homo sapiens
actinomyces meyeri	Bacteria	1	homo sapiens
actinomyces naeslundii	Bacteria	1	homo sapiens
actinomyces neuii	Bacteria	1	homo sapiens
actinomyces odontolyticus	Bacteria	1	homo sapiens
actinomyces oricola	Bacteria	1	homo sapiens
actinomyces oris	Bacteria	1	homo sapiens
actinomyces radingae	Bacteria	1	homo sapiens
actinomyces turicensis	Bacteria	1	homo sapiens
actinomyces urogenitalis	Bacteria	1	homo sapiens
actinomyces viscosus	Bacteria	2	canis lupus familiaris; homo sapiens
adlercreutzia equolifaciens	Bacteria	1	homo sapiens
aedes aegypti	Arthropod	1	homo sapiens
aerococcus christensenii	Bacteria	1	homo sapiens
aerococcus sanguinicola	Bacteria	1	homo sapiens
aerococcus viridans	Bacteria	2	bos taurus; homo sapiens
aeromonas aquariorum	Bacteria	1	homo sapiens
aeromonas bestiarum	Bacteria	5	anguilla anguilla; homo sapiens; oncorhynchus mykiss; petromyzon marinus; salmo salar
aeromonas caviae	Bacteria	7	ctenopharyngodon idella; gallus gallus; homo sapiens; hypophthalmichthys molitrix; musca domestica; ovis aries; sinonovacula constricta
aeromonas enteropelogenes	Bacteria	5	anopheles stephensi; culex quinquefasciatus; homo sapiens; parastromateus niger; procambarus clarkii
aeromonas hydrophila	Bacteria	50	acipenser schrenckii; alligator sinensis; ameiurus nebulosus; anguilla anguilla; anguilla japonica; anopheles maculipennis; barbonymus gonionotus; brassica napus; brycon orbignyanus; canis lupus familiaris; carassius auratus; carassius carassius; catla catla; ctenopharyngodon idella; culex quinquefasciatus; cyprinus carpio; equus caballus; eunectes notaeus; felis catus; gallus gallus; homo sapiens; hoplobatrachus rugulosus; hypophthalmichthys molitrix; hyriopsis cumingii; ictalurus punctatus; labeo rohita; leiocassis longirostris; megalobrama amblycephala; meleagris gallopavo; monopterus albus; mylopharyngodon piceus; oncorhynchus mykiss; oreochromis niloticus; oryctolagus cuniculus; ovis aries; pantherophis guttatus; parabramis pekinensis; paralichthys olivaceus; pelodiscus sinensis; plecoglossus altivelis; procambarus clarkii; pseudorasbora parva; rana aurora; rana chensinensis; salvadora hexalepis; squalius cephalus; sus scrofa; sus scrofa domesticus; varanus niloticus; whitmania pigra
aeromonas salmonicida	Bacteria	23	anarhichas minor; anoplopoma fimbria; carassius auratus; donax trunculus; gadus morhua; gallus gallus; homo sapiens; hypophthalmichthys nobilis; kareius bicoloratus; ompok bimaculatus; oncorhynchus keta; oncorhynchus masou; oncorhynchus mykiss; oncorhynchus nerka; perca fluviatilis; phragmites australis; ruditapes decussatus; ruditapes philippinarum; rutilus rutilus; salmo salar; salvelinus alpinus; salvelinus fontinalis; scophthalmus maximus
aeromonas sobria	Bacteria	16	anopheles stephensi; carassius carassius; carassius gibelio; ctenopharyngodon idella; cyprinus carpio; homo sapiens; ictalurus punctatus; leiocassis longirostris; misgurnus anguillicaudatus; ompok bimaculatus; oncorhynchus mykiss; ovis aries; parabramis pekinensis; pelodiscus sinensis; salmo trutta; squalius cephalus
aeromonas tecta	Bacteria	1	homo sapiens
aeromonas veronii	Bacteria	31	acipenser sturio; anas platyrhynchos; anopheles stephensi; batrachuperus pinchonii; carassius auratus; catla catla; cirrhinus mrigala; ctenopharyngodon idella; culex quinquefasciatus; cyprinus carpio; eriocheir sinensis; gallus gallus; hirudo orientalis; hirudo verbana; homo sapiens; hypophthalmichthys nobilis; hyriopsis cumingii; ictalurus punctatus; macrobrachium nipponense; macrobrachium rosenbergii; monopterus albus; musca domestica; ompok bimaculatus; oreochromis mossambicus; oreochromis niloticus; parabramis pekinensis; pelodiscus sinensis; pelteobagrus fulvidraco; sialia sialis; siniperca chuatsi; squalius cephalus
aggregatibacter actinomycetemcomitans	Bacteria	2	homo sapiens; ovis aries
aggregatibacter aphrophilus	Bacteria	1	homo sapiens
aggregatibacter segnis	Bacteria	2	homo sapiens; pelodiscus sinensis
agrobacterium larrymoorei	Bacteria	6	anthyllis vulneraria; brassica rapa; ficus benjamina; homo sapiens; oryza sativa; phaseolus vulgaris
agrobacterium rhizogenes	Bacteria	10	calliandra houstoniana; cytisus striatus; erythrophleum fordii; glycine soja; homo sapiens; leucaena leucocephala; phaseolus vulgaris; prunus persica; robinia pseudoacacia; vaccinium corymbosum
agrobacterium tumefaciens	Bacteria	54	acacia longifolia; acacia seyal; anthyllis vulneraria; bistorta vivipara; boehmeria nivea; brassica rapa; bursaphelenchus mucronatus; bursaphelenchus xylophilus; caragana korshinskii; carica papaya; citrullus lanatus; crotalaria pallida; euonymus alatus; flacourtia indica; glycine max; glycine soja; gossypium hirsutum; homo sapiens; humulus lupulus; lablab purpureus; lemna minor; lotus corniculatus; medicago lupulina; medicago polymorpha; medicago sativa; moringa oleifera; musa acuminata; nicotiana tabacum; oryza sativa; paeonia ostii; panax ginseng; parthenium hysterophorus; phaseolus vulgaris; phyla canescens; populus alba; prosopis juliflora; prunus cerasifera; prunus cerasus; prunus dulcis; prunus persica; pyrus communis; raphanus sativus; robinia pseudoacacia; rubus idaeus; rubus ursinus; salvia miltiorrhiza; senna surattensis; solanum lycopersicum; solanum nigrum; sophora alopecuroides; vaccinium corymbosum; vicia cracca; vigna unguiculata; vitis vinifera
agrococcus baldri	Bacteria	1	homo sapiens
aichi virus	Virus	1	homo sapiens
ajellomyces capsulatus	Fungi	15	artibeus hirsutus; bos taurus; canis lupus familiaris; desmodus rotundus; equus caballus; felis catus; homo sapiens; leptonycteris curasoae; leptonycteris nivalis; meles meles; molossus molossus; ovis aries; pteronotus davyi; sus scrofa; tadarida brasiliensis
ajellomyces dermatitidis	Fungi	3	canis lupus familiaris; felis catus; homo sapiens
alistipes onderdonkii	Bacteria	1	homo sapiens
alistipes shahii	Bacteria	1	homo sapiens
alloiococcus otitis	Bacteria	1	homo sapiens
alternaria alternata	Fungi	5	canis lupus familiaris; equus caballus; felis catus; homo sapiens; lagenorhynchus obliquidens
alternaria triticina	Fungi	1	homo sapiens
amblyomma dubitatum	Arthropod	4	didelphis albiventris; dusicyon thous; homo sapiens; hydrochoerus hydrochaeris
amblyomma tapirellum	Arthropod	1	homo sapiens
amblyomma testudinarium	Arthropod	2	elaphe climacophora; homo sapiens
anaerococcus lactolyticus	Bacteria	1	homo sapiens
anaerococcus tetradius	Bacteria	1	homo sapiens
anaeroglobus geminatus	Bacteria	1	homo sapiens
anaerostipes caccae	Bacteria	1	homo sapiens
anaplasma ovis	Bacteria	14	argas persicus; bos taurus; capra hircus; capreolus capreolus; cervus elaphus; dermacentor niveus; haemaphysalis concinna; haemaphysalis punctata; homo sapiens; ixodes ricinus; odocoileus hemionus; ovis aries; ovis canadensis; rhipicephalus sanguineus
anaplasma phagocytophilum	Bacteria	64	apodemus agrarius; apodemus draco; apodemus latronum; bison bonasus; bos taurus; canis lupus; canis lupus familiaris; capra hircus; capra ibex; capreolus capreolus; cervus elaphus; dama dama; dermacentor reticulatus; dermacentor silvarum; eothenomys cachinus; eothenomys custos; eothenomys eleusis; equus asinus; equus caballus; erinaceus europaeus; felis catus; haemaphysalis concinna; haemaphysalis longicornis; homo sapiens; hyalomma detritum; hydropotes inermis; ixodes hexagonus; ixodes ovatus; ixodes pacificus; ixodes persulcatus; ixodes ricinus; ixodes scapularis; lepus europaeus; lipoptena cervi; microtus oeconomus; mus musculus; myodes glareolus; myodes rufocanus; myodes rutilus; neotoma fuscipes; niviventer confucianus; niviventer coxingi; niviventer eha; niviventer niviventer; odocoileus virginianus; ovis aries; perdix perdix; peromyscus gossypinus; rattus losea; rattus norvegicus; rhipicephalus microplus; rhipicephalus sanguineus; rupicapra rupicapra; sceloporus occidentalis; sciurus carolinensis; sciurus griseus; sigmodon hispidus; sus scrofa; sylvilagus audubonii; sylvilagus floridanus; tamias sibiricus; tscherskia triton; ursus arctos; vulpes vulpes
ancylostoma braziliense	Helminth	3	canis lupus familiaris; felis catus; homo sapiens
ancylostoma caninum	Helminth	5	canis latrans; canis lupus; canis lupus familiaris; homo sapiens; vulpes vulpes
ancylostoma ceylanicum	Helminth	5	canis lupus; canis lupus familiaris; felis catus; homo sapiens; mesocricetus auratus
ancylostoma duodenale	Helminth	2	canis lupus familiaris; homo sapiens
andes virus	Virus	13	abrothrix longipilis; akodon montensis; auliscomys micropus; bolomys lasiurus; homo sapiens; oligoryzomys chacoensis; oligoryzomys flavescens; oligoryzomys fulvescens; oligoryzomys longicaudatus; oligoryzomys nigripes; oxymycterus nasutus; rattus norvegicus; rattus rattus
angiostrongylus cantonensis	Helminth	7	canis lupus familiaris; homo sapiens; niviventer andersoni; parmarion martensi; pomacea insularum; rattus norvegicus; rattus rattus
angiostrongylus costaricensis	Helminth	3	homo sapiens; mus musculus; sigmodon hispidus
anisakis physeteris	Helminth	10	auxis thazard; beryx splendens; etmopterus spinax; homo sapiens; merluccius polli; pagellus bogaraveo; physeter catodon; sotalia fluviatilis; synaphobranchus kaupii; ziphius cavirostris
anisakis simplex	Helminth	25	belone belone; clupea harengus; cololabis saira; eleginus navaga; gadus morhua; gadus ogac; globicephala melas; homo sapiens; macrourus berglax; melanogrammus aeglefinus; micromesistius poutassou; myctophum punctatum; myoxocephalus scorpius; notothenia coriiceps; oncorhynchus gorbuscha; oncorhynchus keta; oncorhynchus nerka; pagellus bogaraveo; pollachius virens; reinhardtius hippoglossoides; salmo salar; scomber scombrus; theragra chalcogramma; todarodes pacificus; trachyrincus scabrus
anncaliia algerae	Fungi	2	anopheles stephensi; homo sapiens
anoxybacillus pushchinoensis	Bacteria	1	homo sapiens
aonchotheca philippinensis	Helminth	1	homo sapiens
apophysomyces elegans	Fungi	1	homo sapiens
aquamicrobium lusatiense	Bacteria	1	homo sapiens
arachnomyces nodosetosus	Fungi	1	homo sapiens
arcanobacterium bernardiae	Bacteria	1	homo sapiens
arcanobacterium haemolyticum	Bacteria	3	equus caballus; homo sapiens; meles meles
arcanobacterium pyogenes	Bacteria	9	bison bonasus; bos taurus; equus caballus; gazella subgutturosa; homo sapiens; naemorhedus goral; odocoileus virginianus; sus scrofa; sus scrofa domesticus
arcobacter butzleri	Bacteria	4	bos taurus; homo sapiens; hylobates moloch; sus scrofa
arcobacter cryaerophilus	Bacteria	4	bos taurus; homo sapiens; sus scrofa; sus scrofa domesticus
arthrobacter creatinolyticus	Bacteria	2	culex quinquefasciatus; homo sapiens
arthrobacter mysorens	Bacteria	1	homo sapiens
arthrobacter woluwensis	Bacteria	1	homo sapiens
arthroderma benhamiae	Fungi	8	atelerix albiventris; canis lupus; canis lupus familiaris; cavia porcellus; erethizon dorsatum; erinaceus europaeus; felis catus; homo sapiens
arthroderma fulvum	Fungi	1	homo sapiens
arthroderma grubyi	Fungi	1	homo sapiens
arthroderma gypseum	Fungi	2	homo sapiens; oryctolagus cuniculus
arthroderma obtusum	Fungi	3	homo sapiens; sus scrofa; sus scrofa domesticus
arthroderma otae	Fungi	6	canis lupus; canis lupus familiaris; felis catus; homo sapiens; oryctolagus cuniculus; sus scrofa
arthroderma simii	Fungi	2	gallus gallus; homo sapiens
arthroderma vanbreuseghemii	Fungi	11	canis lupus; canis lupus familiaris; cavia porcellus; chinchilla brevicaudata; chinchilla lanigera; equus caballus; felis catus; homo sapiens; mustela lutreola; oryctolagus cuniculus; rattus norvegicus
arthrographis kalrae	Fungi	2	felis silvestris; homo sapiens
asaia bogorensis	Bacteria	4	homo sapiens; mangifera indica; michelia champaca; tetraponera rufonigra
asaia lannaensis	Bacteria	1	homo sapiens
ascaris lumbricoides	Helminth	3	homo sapiens; sus scrofa; sus scrofa domesticus
ascaris suum	Helminth	5	bos taurus; homo sapiens; ovis aries; sus scrofa; sus scrofa domesticus
aspergillus aculeatinus	Fungi	1	homo sapiens
aspergillus awamori	Fungi	1	homo sapiens
aspergillus calidoustus	Fungi	1	homo sapiens
aspergillus candidus	Fungi	2	homo sapiens; phakellia fusca
aspergillus carbonarius	Fungi	1	homo sapiens
aspergillus clavatus	Fungi	1	homo sapiens
aspergillus flavus	Fungi	5	canis lupus; canis lupus familiaris; gorgonia ventalina; homo sapiens; philanthus triangulum
aspergillus flavus group	Fungi	1	homo sapiens
aspergillus fumigatus	Fungi	6	alcyonidium gelatinosum; carcharodon carcharias; dendroctonus rufipennis; homo sapiens; meleagris gallopavo; phakellia fusca
aspergillus glaucus	Fungi	1	homo sapiens
aspergillus granulosus	Fungi	1	homo sapiens
aspergillus insuetus	Fungi	1	homo sapiens
aspergillus insulicola	Fungi	1	homo sapiens
aspergillus kanagawaensis	Fungi	1	homo sapiens
aspergillus lentulus	Fungi	1	homo sapiens
aspergillus niger	Fungi	11	bos taurus; canis lupus; canis lupus familiaris; capra hircus; equus caballus; felis catus; gorgonia ventalina; homo sapiens; ovis aries; sus scrofa; sus scrofa domesticus
aspergillus novofumigatus	Fungi	1	homo sapiens
aspergillus ochraceus	Fungi	3	gorgonia ventalina; homo sapiens; phakellia fusca
aspergillus oryzae	Fungi	2	bombyx mori; homo sapiens
aspergillus penicillioides	Fungi	1	homo sapiens
aspergillus persii	Fungi	1	homo sapiens
aspergillus sydowii	Fungi	7	canis lupus; canis lupus familiaris; diabrotica virgifera; equus caballus; gorgonia ventalina; homo sapiens; ostrinia nubilalis
aspergillus tamarii	Fungi	5	canis lupus; canis lupus familiaris; gorgonia ventalina; homo sapiens; philanthus triangulum
aspergillus terreus	Fungi	4	canis lupus; canis lupus familiaris; gorgonia ventalina; homo sapiens
aspergillus tritici	Fungi	1	homo sapiens
aspergillus tubingensis	Fungi	4	canis lupus; canis lupus familiaris; flustra foliacea; homo sapiens
aspergillus unguis	Fungi	1	homo sapiens
aspergillus ustus	Fungi	1	homo sapiens
aspergillus versicolor	Fungi	4	canis lupus; canis lupus familiaris; gorgonia ventalina; homo sapiens
aspergillus viridinutans	Fungi	1	homo sapiens
aspergillus wentii	Fungi	1	homo sapiens
aspergillus westerdijkiae	Fungi	1	homo sapiens
atopobium parvulum	Bacteria	1	homo sapiens
atopobium rimae	Bacteria	1	homo sapiens
atopobium vaginae	Bacteria	1	homo sapiens
aurantimonas altamirensis	Bacteria	1	homo sapiens
aureobasidium pullulans	Fungi	4	acropora formosa; diabrotica virgifera; homo sapiens; steganacarus magnus
australian bat lyssavirus	Virus	6	epalzeorhynchos kalopterus; homo sapiens; pteropus alecto; pteropus poliocephalus; pteropus scapulatus; saccolaimus flaviventris
auxarthron umbrinum	Fungi	1	homo sapiens
babesia bovis	Protozoa	9	blastoceros dichotomus; bos indicus; bos taurus; bubalus bubalis; equus caballus; homo sapiens; ixodes ricinus; odocoileus virginianus; rhipicephalus bursa
babesia divergens	Protozoa	10	bos taurus; capra ibex; capreolus capreolus; cervus elaphus; homo sapiens; ixodes persulcatus; ixodes ricinus; meriones unguiculatus; oryctolagus cuniculus; rangifer tarandus
babesia duncani	Protozoa	1	homo sapiens
babesia gibsoni	Protozoa	10	bos taurus; canis lupus; canis lupus familiaris; equus caballus; haemaphysalis longicornis; homo sapiens; ovis aries; paguma larvata; rhipicephalus sanguineus; sus scrofa
babesia microti	Protozoa	24	apodemus agrarius; apodemus argenteus; apodemus flavicollis; apodemus speciosus; canis lupus; canis lupus familiaris; eothenomys andersoni; equus caballus; homo sapiens; ixodes persulcatus; ixodes ricinus; ixodes scapularis; macaca fuscata; macaca mulatta; mesocricetus auratus; microtus agrestis; microtus arvalis; microtus oeconomus; myodes glareolus; myodes rufocanus; myodes rutilus; niviventer confucianus; procyon lotor; sciurus vulgaris
bacillus anthracis	Bacteria	45	allamanda cathartica; ananas comosus; bos taurus; bougainvillea spectabilis; canis lupus familiaris; capra hircus; capsicum annuum; carica papaya; caryota mitis; catharanthus roseus; ceiba pentandra; centella asiatica; cinnamomum pauciflorum; cocos nucifera; cordyline fruticosa; curcuma longa; cymbopogon citratus; cyrtostachys renda; durio zibethinus; elaeis guineensis; equus caballus; felis catus; ficus benjamina; hevea brasiliensis; homo sapiens; hylocereus undatus; lagerstroemia speciosa; mangifera indica; manihot esculenta; nephelium lappaceum; nicotiana tabacum; oryza sativa; ovis aries; perinereis aibuhitensis; plocamium telfairiae; plumeria obtusa; populus euphratica; saccharum officinarum; solanum tuberosum; sus scrofa; sus scrofa domesticus; tectona grandis; terminalia catappa; tridax procumbens; zea mays
bacillus aquimaris	Bacteria	5	citrus limon; gymnanthemum amygdalinum; homo sapiens; musa acuminata; takifugu oblongus
bacillus cereus	Bacteria	136	agave americana; agave salmiana; alexandrium minutum; allamanda cathartica; aloe vera; amblyomma cajennense; ananas comosus; anopheles stephensi; apis cerana; apis mellifera; aquilaria malaccensis; artocarpus heterophyllus; artocarpus integer; avicennia marina; azadirachta indica; bactrocera zonata; bemisia tabaci; bistorta vivipara; bombyx mori; bos taurus; bougainvillea spectabilis; brassica napus; brassica rapa; capsicum annuum; carica papaya; carludovica palmata; caryota mitis; catharanthus roseus; ceiba pentandra; centella asiatica; chenopodium album; chenopodium quinoa; chionoecetes japonicus; citrullus lanatus; coptotermes curvignathus; cordyline fruticosa; culex quinquefasciatus; curcuma longa; cymbopogon citratus; cypripedium flavum; cytisus striatus; dimocarpus longan; durio zibethinus; elaeis guineensis; ficus benjamina; ficus deltoidea; ficus elastica; ficus microcarpa; gelidium amansii; gliricidia sepium; glycine max; gossypium hirsutum; grateloupia filicina; gymnanthemum amygdalinum; helianthus annuus; heliconia latispatha; hevea brasiliensis; homo sapiens; hylocereus undatus; hymenocallis littoralis; ixora coccinea; lagenaria siceraria; lagerstroemia speciosa; lantana camara; litsea cubeba; lolium perenne; lutzomyia longipalpis; mangifera indica; manihot esculenta; mimusops elengi; mugil cephalus; murraya koenigii; musa acuminata; nasturtium officinale; nelumbo nucifera; nepenthes mirabilis; nephelium lappaceum; nicotiana attenuata; nicotiana tabacum; nilaparvata lugens; nothapodytes nimmoniana; orthosiphon stamineus; oryctolagus cuniculus; oryza sativa; paeonia ostii; panax ginseng; pandanus amaryllifolius; pelodiscus sinensis; petalonia fascia; phaseolus vulgaris; phenacoccus solenopsis; phoenix canariensis; phoenix dactylifera; phoenix roebelenii; pholcus phalangioides; phragmites australis; piper nigrum; pisum sativum; pleurotus eryngii; plumeria obtusa; poekilocerus pictus; polyalthia longifolia; reticulitermes flaviceps; reticulitermes santonensis; rhizophora apiculata; roystonea borinquena; saccharum officinarum; sansevieria trifasciata; sardinella longiceps; sargassum fusiforme; sargassum serratifolium; scylla paramamosain; scytosiphon lomentaria; sogatella furcifera; solanum lycopersicum; solanum tuberosum; solenopsis invicta; sophora alopecuroides; sus scrofa; syzygium cumini; takifugu rubripes; tamarindus indica; taxus globosa; tectona grandis; terminalia catappa; thanatephorus cucumeris; theobroma cacao; trachycarpus fortunei; tradescantia spathacea; trichogramma chilonis; trichosanthes cucumerina; tridax procumbens; triticum aestivum; vicia faba; zea mays; zingiber officinale
bacillus clausii	Bacteria	4	brassica rapa; homo sapiens; lomentaria catenata; suberites domuncula
bacillus coagulans	Bacteria	3	gallus gallus; homo sapiens; triticum aestivum
bacillus endophyticus	Bacteria	11	azadirachta indica; glossina fuscipes; homo sapiens; kobresia capillifolia; litopenaeus vannamei; musa acuminata; nicotiana attenuata; nicotiana glauca; ocimum basilicum; phaseolus vulgaris; zea mays
bacillus flexus	Bacteria	16	ananas comosus; apis mellifera; citrus limon; culex quinquefasciatus; etroplus suratensis; hevea brasiliensis; homo sapiens; nephelium lappaceum; panax ginseng; populus euphratica; prosopis juliflora; ricinus communis; terminalia catappa; theobroma cacao; tradescantia spathacea; zea mays
bacillus licheniformis	Bacteria	47	acacia senegal; acanthella acuta; alnus glutinosa; aloe vera; aquilaria beccariana; aquilaria crassna; aquilaria malaccensis; azadirachta indica; betula pendula; bos taurus; bougainvillea spectabilis; brassica rapa; buxbaumia aphylla; canis lupus; canis lupus familiaris; ceiba pentandra; chionoecetes japonicus; culex quinquefasciatus; erythrina fusca; etroplus suratensis; fragaria vesca; homo sapiens; larimichthys crocea; mangifera indica; musa acuminata; ovis aries; pennisetum glaucum; perna viridis; phragmites australis; piper nigrum; porites lutea; prays oleae; prosopis strombulifera; raphanus sativus; reticulitermes chinensis; rhizophora mucronata; saccharum officinarum; sophora alopecuroides; sorbus aucuparia; sphaerophysa salsula; sphagnum fallax; sphagnum magellanicum; syzygium cumini; taeniopygia guttata; triticum aestivum; yunnanacris yunnaneus; zea mays
bacillus megaterium	Bacteria	94	abelmoschus esculentus; acacia auriculiformis; acacia mangium; adenanthera pavonina; aedes albopictus; agave americana; agave salmiana; allamanda cathartica; aloe vera; ananas comosus; apis mellifera; aplysina insularis; aquilaria sinensis; artocarpus heterophyllus; artocarpus integer; azadirachta indica; bougainvillea spectabilis; brassica rapa; bruguiera gymnorhiza; capsicum annuum; carica papaya; carludovica palmata; caryota mitis; catharanthus roseus; centella asiatica; centrosema pubescens; cinnamomum pauciflorum; citrus limon; citrus maxima; cocos nucifera; cordyline fruticosa; couroupita guianensis; curcuma longa; cymbopogon citratus; cyrtostachys renda; durio zibethinus; elaeis guineensis; erythrophleum fordii; escherichia coli; ficus deltoidea; ficus racemosa; heliconia latispatha; hevea brasiliensis; homo sapiens; hymenocallis littoralis; isochrysis galbana; ixora coccinea; kandelia candel; labeo rohita; lagerstroemia speciosa; lantana camara; leucaena leucocephala; lonicera japonica; mammillaria fraileana; mangifera indica; manihot esculenta; manilkara zapota; mimosa bimucronata; momordica charantia; murraya koenigii; nicotiana attenuata; nicotiana glauca; oryza sativa; panax ginseng; pandanus amaryllifolius; perilla frutescens; phaseolus vulgaris; philodendron bipinnatifidum; phoenix dactylifera; phoenix roebelenii; piper nigrum; pisum sativum; plumeria obtusa; polyalthia longifolia; prunus dulcis; ricinus communis; roystonea borinquena; saccharum officinarum; sansevieria trifasciata; solanum melongena; syzygium cumini; talipariti hamabo; tamarindus indica; taxus globosa; tectona grandis; theobroma cacao; tradescantia spathacea; tridax procumbens; triticum aestivum; vigna umbellata; vitis vinifera; zea mays; zenia insignis; zootermopsis angusticollis
bacillus mojavensis	Bacteria	9	bistorta vivipara; gentiana macrophylla; gossypium barbadense; homo sapiens; phoenix dactylifera; punica granatum; sophora alopecuroides; vigna mungo; zea mays
bacillus pumilus	Bacteria	120	acanthella acuta; ailanthus altissima; alexandrium minutum; allamanda cathartica; aloe vera; ananas comosus; anopheles stephensi; apis cerana; apis mellifera; aquilaria beccariana; aquilaria malaccensis; aquilaria sinensis; areca catechu; artocarpus heterophyllus; artocarpus integer; asobara tabida; axinella polypoides; azadirachta indica; beta vulgaris; bistorta vivipara; bos taurus; bougainvillea spectabilis; brassica napus; brassica oleracea; brassica rapa; bruguiera gymnorhiza; capsicum annuum; carica papaya; catharanthus roseus; ceiba pentandra; chionoecetes japonicus; chondrus ocellatus; cinnamomum verum; citrullus lanatus; citrus maxima; cocos nucifera; colpomenia sinuosa; curcuma longa; cyrtostachys renda; durio zibethinus; echinacea pallida; echinacea purpurea; ecklonia cava; elaeis guineensis; ficus benjamina; fucus vesiculosus; gallus gallus; gentiana macrophylla; glomus intraradices; glycine max; gossypium hirsutum; gymnanthemum amygdalinum; halichondria rugosa; halodule pinifolia; heliconia latispatha; helicoverpa armigera; hevea brasiliensis; hibiscus cannabinus; homo sapiens; hymenocallis littoralis; ixodes ricinus; jatropha curcas; kappaphycus alvarezii; lagenaria siceraria; laminaria digitata; larimichthys crocea; lolium perenne; lomentaria catenata; mangifera indica; manihot esculenta; medicago truncatula; musa acuminata; nepenthes rafflesiana; nephelium lappaceum; nicotiana attenuata; nicotiana tabacum; nothapodytes nimmoniana; orthosiphon stamineus; oryza sativa; pachycereus pringlei; padina pavonica; paeonia ostii; palmaria palmata; panax ginseng; pandanus amaryllifolius; panicum virgatum; penaeus monodon; petrosia ficiformis; phaseolus vulgaris; phragmites australis; piper nigrum; plumeria obtusa; polyalthia longifolia; populus euphratica; porphyra yezoensis; prosopis strombulifera; rhizophora mucronata; rhizophora stylosa; roystonea borinquena; sargassum fusiforme; sogatella furcifera; solanum lycopersicum; solanum tuberosum; solenopsis invicta; sophora alopecuroides; sorbus aucuparia; sphaerophysa salsula; sphagnum fallax; sphagnum magellanicum; tamarindus indica; taxus globosa; terminalia catappa; tethya aurantium; theobroma cacao; tradescantia spathacea; tridax procumbens; triticum aestivum; vigna unguiculata; vitis vinifera; zea mays
bacillus subtilis	Bacteria	166	abelmoschus esculentus; acacia mearnsii; adenanthera pavonina; aedes aegypti; agave americana; alexandrium minutum; allamanda cathartica; alligator sinensis; allium sativum; aloe vera; amorphophallus konjac; ananas comosus; anticarsia gemmatalis; apis cerana; apis mellifera; apium graveolens; apocynum venetum; aquilaria malaccensis; arabidopsis thaliana; arachis hypogaea; arctium lappa; areca catechu; artocarpus heterophyllus; azadirachta indica; bactrocera zonata; belamcanda chinensis; beta vulgaris; betula pendula; bistorta vivipara; bombyx mori; bos taurus; bougainvillea spectabilis; brassica napus; brassica rapa; cajanus cajan; calotropis gigantea; canis lupus; canis lupus familiaris; carica papaya; caryota mitis; catharanthus roseus; centella asiatica; chamaecyparis lawsoniana; chanos chanos; chionoecetes japonicus; choristoneura fumiferana; cinnamomum camphora; cinnamomum pauciflorum; citrus limon; cocos nucifera; colletotrichum musae; cordyline fruticosa; cucumis sativus; culex quinquefasciatus; cyrtostachys renda; cytisus striatus; dalbergia odorifera; dalbulus maidis; dimocarpus longan; dioscorea zingiberensis; durio zibethinus; dysidea avara; elaeis guineensis; erythrina fusca; erythrophleum fordii; gallus gallus; gentiana macrophylla; glycine max; gmelina arborea; gossypium barbadense; gossypium hirsutum; halichondria rugosa; harmonia axyridis; helianthus annuus; heliconia latispatha; helicoverpa armigera; hevea brasiliensis; hofmannophila pseudospretella; homarus americanus; homo sapiens; hylocereus undatus; indigofera tinctoria; ixodes ricinus; ixora coccinea; jatropha curcas; juniperus virginiana; kobresia capillifolia; labeo rohita; lactuca sativa; lagerstroemia speciosa; larimichthys crocea; lates calcarifer; leucaena leucocephala; leucojum aestivum; litopenaeus vannamei; litsea cubeba; lonicera japonica; mangifera indica; metroxylon sagu; morinda citrifolia; morus alba; murraya koenigii; mus musculus; musa acuminata; nepenthes rafflesiana; nephelium lappaceum; nicotiana tabacum; nothapodytes nimmoniana; ocimum tenuiflorum; oryza sativa; padina arborescens; paeonia anomala; panax ginseng; pandanus amaryllifolius; parthenium hysterophorus; pelargonium graveolens; penaeus monodon; phaseolus vulgaris; pheretima sieboldi; phoenix dactylifera; piper nigrum; plumeria obtusa; populus euphratica; prosopis cineraria; prosopis strombulifera; prunus armeniaca; prunus dulcis; psidium guajava; punica granatum; raphanus sativus; ravenala madagascariensis; rhizophora apiculata; ricinus communis; roystonea borinquena; saccharum officinarum; sansevieria trifasciata; sebastiscus marmoratus; solanum lycopersicum; solanum melongena; solanum tuberosum; solenopsis invicta; sophora alopecuroides; sorbus aucuparia; stipa purpurea; syzygium aqueum; syzygium cumini; talipariti hamabo; tamarindus indica; tectona grandis; terminalia catappa; tethya aurantium; thanatephorus cucumeris; theobroma cacao; thorectes lusitanicus; trachycarpus fortunei; tribulus terrestris; trichogramma chilonis; tridax procumbens; triticum aestivum; vetiveria zizanioides; vigna mungo; vigna umbellata; vitis vinifera; yunnanacris yunnaneus; zea mays; zingiber officinale
bacillus thioparans	Bacteria	1	homo sapiens
bacillus thuringiensis	Bacteria	48	alexandrium minutum; allamanda cathartica; allium sativum; aloe vera; anagasta kuehniella; ananas comosus; apis cerana; apis mellifera; artocarpus heterophyllus; artocarpus integer; azadirachta indica; bemisia tabaci; biomphalaria alexandrina; bombyx mori; brassica rapa; capsicum annuum; carica papaya; cinnamomum pauciflorum; citrus limon; curculio nucum; elaeis guineensis; etroplus suratensis; ginkgo biloba; gryllotalpa gryllotalpa; harmonia axyridis; homo sapiens; leptinotarsa decemlineata; magnolia denudata; nephelium lappaceum; oryza sativa; panax ginseng; phaseolus vulgaris; phoenix canariensis; phyllostachys edulis; pieris brassicae; saccharum officinarum; sardinella longiceps; sogatella furcifera; solenopsis invicta; sphaerophysa salsula; spodoptera frugiperda; tectona grandis; thanatephorus cucumeris; vitis vinifera; wohlfahrtia magnifica; xyleborus dispar; zea mays; zootermopsis angusticollis
bacteroides caccae	Bacteria	1	homo sapiens
bacteroides clarus	Bacteria	1	homo sapiens
bacteroides coprocola	Bacteria	1	homo sapiens
bacteroides dorei	Bacteria	1	homo sapiens
bacteroides eggerthii	Bacteria	1	homo sapiens
bacteroides finegoldii	Bacteria	1	homo sapiens
bacteroides fluxus	Bacteria	1	homo sapiens
bacteroides fragilis	Bacteria	8	bos taurus; capra hircus; equus caballus; felis catus; homo sapiens; ovis aries; sus scrofa; sus scrofa domesticus
bacteroides heparinolyticus	Bacteria	1	homo sapiens
bacteroides ovatus	Bacteria	1	homo sapiens
bacteroides stercoris	Bacteria	1	homo sapiens
bacteroides thetaiotaomicron	Bacteria	1	homo sapiens
bacteroides uniformis	Bacteria	2	homo sapiens; mus musculus
bacteroides ureolyticus	Bacteria	1	homo sapiens
bacteroides vulgatus	Bacteria	4	gallus gallus; homo sapiens; mus musculus; sus scrofa
bacteroides xylanisolvens	Bacteria	1	homo sapiens
balamuthia mandrillaris	Protozoa	1	homo sapiens
balantidium coli	Protozoa	7	canis lupus familiaris; gorilla gorilla; homo sapiens; papio hamadryas; struthio camelus; sus scrofa; sus scrofa domesticus
banna virus	Virus	10	aedes albopictus; aedes vexans; anopheles sinensis; culex annulus; culex modestus; culex pipiens; culex tritaeniorhynchus; homo sapiens; ochlerotatus dorsalis; sus scrofa domesticus
barmah forest virus	Virus	3	culex annulirostris; homo sapiens; ochlerotatus vigilax
bartonella bacilliformis	Bacteria	1	homo sapiens
bartonella elizabethae	Bacteria	7	apodemus sylvaticus; canis lupus; canis lupus familiaris; homo sapiens; meriones libycus; rattus norvegicus; suncus murinus
bartonella henselae	Bacteria	15	amblyomma cajennense; bos taurus; canis lupus; canis lupus familiaris; ctenocephalides felis; equus caballus; felis catus; homo sapiens; ixodes persulcatus; lipoptena mazamae; macaca fascicularis; ovis aries; phocoena phocoena; puma concolor; rhipicephalus sanguineus
bartonella quintana	Bacteria	4	canis lupus; canis lupus familiaris; homo sapiens; macaca mulatta
bartonella rochalimae	Bacteria	5	canis lupus; canis lupus familiaris; homo sapiens; pulex irritans; rattus norvegicus
bartonella tamiae	Bacteria	1	homo sapiens
bartonella vinsonii	Bacteria	7	aetheca wagneri; canis lupus; canis lupus familiaris; ctenophthalmus pseudagyrtes; homo sapiens; orchopeas leucopus; oropsylla hirsuta
bartonella washoensis	Bacteria	16	aetheca wagneri; cediopsylla inaequalis; cynomys ludovicianus; glaucomys volans; homo sapiens; orchopeas leucopus; oropsylla hirsuta; pulex irritans; sciurus vulgaris; spermophilus beecheyi; spermophilus columbianus; spermophilus dauricus; spermophilus richardsonii; spermophilus tridecemlineatus; tamias sibiricus; tamiasciurus hudsonicus
basidiobolus ranarum	Fungi	1	homo sapiens
baylisascaris procyonis	Helminth	3	canis lupus familiaris; homo sapiens; procyon lotor
bayou virus	Virus	2	homo sapiens; oryzomys palustris
beauveria bassiana	Fungi	26	agrilus planipennis; anomala corpulenta; choristoneura fumiferana; cydia pomonella; dendroctonus ponderosae; dendroctonus rufipennis; diatraea saccharalis; dioryctria sylvestrella; dryocoetes autographus; euproctis chrysorhoea; galleria mellonella; homo sapiens; hylurgops palliatus; hylurgus ligniperda; hypothenemus hampei; ips sexdentatus; ips typographus; leptinotarsa decemlineata; meligethes aeneus; monochamus alternatus; monochamus saltuarius; nilaparvata lugens; pieris rapae; reticulitermes flavipes; thaumetopoea pityocampa; tomicus piniperda
bertiella mucronata	Helminth	1	homo sapiens
bertiella studeri	Helminth	1	homo sapiens
betacoronavirus 1	Virus	15	bos taurus; bubalus bubalis; canis lupus; canis lupus familiaris; equus caballus; giraffa camelopardalis; hemitragus jemlahicus; homo sapiens; kobus ellipsiprymnus; lama pacos; odocoileus virginianus; rusa unicolor; sus scrofa; tragelaphus angasii; tragelaphus spekii
bhanja virus	Virus	2	homo sapiens; rhipicephalus decoloratus
bifidobacterium adolescentis	Bacteria	2	elephas maximus; homo sapiens
bifidobacterium animalis	Bacteria	3	homo sapiens; rattus norvegicus; sus scrofa
bifidobacterium bifidum	Bacteria	1	homo sapiens
bifidobacterium breve	Bacteria	1	homo sapiens
bifidobacterium catenulatum	Bacteria	1	homo sapiens
bifidobacterium dentium	Bacteria	1	homo sapiens
bifidobacterium kashiwanohense	Bacteria	1	homo sapiens
bifidobacterium longum	Bacteria	1	homo sapiens
bifidobacterium pseudocatenulatum	Bacteria	1	homo sapiens
bifidobacterium scardovii	Bacteria	1	homo sapiens
bifidobacterium thermophilum	Bacteria	2	homo sapiens; sus scrofa
bilharziella polonica	Helminth	8	anas crecca; anas platyrhynchos; ardea cinerea; aythya fuligula; cygnus olor; grus grus; homo sapiens; planorbis planorbis
bilophila wadsworthia	Bacteria	1	homo sapiens
bk polyomavirus	Virus	1	homo sapiens
blastocystis hominis	Protozoa	5	bos taurus; canis lupus familiaris; equus caballus; homo sapiens; sus scrofa
blautia producta	Bacteria	1	homo sapiens
blautia wexlerae	Bacteria	1	homo sapiens
bordetella bronchiseptica	Bacteria	10	bos taurus; canis lupus; canis lupus familiaris; equus caballus; felis catus; homo sapiens; oryctolagus cuniculus; ovis aries; sus scrofa; sus scrofa domesticus
bordetella hinzii	Bacteria	3	gallus gallus; homo sapiens; rattus tanezumi
bordetella holmesii	Bacteria	1	homo sapiens
bordetella parapertussis	Bacteria	2	homo sapiens; ovis aries
bordetella pertussis	Bacteria	1	homo sapiens
bordetella petrii	Bacteria	1	homo sapiens
bordetella trematum	Bacteria	1	homo sapiens
borna disease virus	Virus	34	amazona aestiva; anas platyrhynchos; anodorhynchus hyacinthinus; ara ararauna; ara chloropterus; ara severa; aratinga erythrogenys; aratinga solstitialis; bos taurus; cacatua alba; cacatua ducorpsii; cacatua moluccensis; cacatua sulphurea; canis lupus; canis lupus familiaris; corvus monedula; crocidura leucodon; deroptyus accipitrinus; eclectus roratus; eolophus roseicapillus; equus asinus; equus caballus; felis catus; homo sapiens; lama pacos; oryctolagus cuniculus; ovis aries; pionus fuscus; pionus maximiliani; probosciger aterrimus; procyon lotor; psittacus erithacus; serinus canaria; vulpes vulpes
borrelia afzelii	Bacteria	20	apodemus agrarius; apodemus flavicollis; apodemus uralensis; canis lupus familiaris; haemaphysalis concinna; homo sapiens; ixodes canisuga; ixodes pavlovskyi; ixodes persulcatus; ixodes ricinus; ixodes trianguliceps; meles meles; microtus agrestis; microtus arvalis; microtus oeconomus; myodes glareolus; myodes rufocanus; myodes rutilus; peromyscus gossypinus; sorex araneus
borrelia americana	Bacteria	4	homo sapiens; ixodes minor; ixodes ricinus; thryothorus ludovicianus
borrelia andersonii	Bacteria	3	amblyomma americanum; homo sapiens; ixodes scapularis
borrelia bissettii	Bacteria	15	homo sapiens; ixodes affinis; ixodes auritulus; ixodes canisuga; ixodes minor; ixodes pacificus; ixodes ricinus; ixodes scapularis; ixodes spinipalpis; microtus ochrogaster; neotoma floridana; neotoma fuscipes; neotoma mexicana; peromyscus gossypinus; sigmodon hispidus
borrelia burgdorferi	Bacteria	43	amblyomma americanum; apodemus flavicollis; bos taurus; canis lupus; canis lupus familiaris; capreolus capreolus; cervus nippon; dama dama; equus caballus; glaucomys volans; haemaphysalis longicornis; homo sapiens; ixodes affinis; ixodes canisuga; ixodes granulatus; ixodes minor; ixodes pacificus; ixodes persulcatus; ixodes ricinus; ixodes scapularis; ixodes uriae; microtus californicus; mus musculus; myodes glareolus; myodes rutilus; neotoma floridana; neotoma fuscipes; neotoma lepida; ochrotomys nuttalli; odocoileus hemionus; ornithodoros coriaceus; oryzomys palustris; ovis aries; peromyscus boylii; peromyscus californicus; peromyscus gossypinus; peromyscus leucopus; plestiodon fasciatus; procyon lotor; rattus norvegicus; reithrodontomys megalotis; sigmodon hispidus; terrapene carolina
borrelia crocidurae	Bacteria	3	homo sapiens; mastomys natalensis; ornithodoros sonrai
borrelia duttonii	Bacteria	2	homo sapiens; ornithodoros moubata
borrelia garinii	Bacteria	28	apodemus flavicollis; apodemus speciosus; apodemus uralensis; calidris minuta; canis lupus familiaris; dermacentor reticulatus; eothenomys smithii; haemaphysalis flava; homo sapiens; ixodes canisuga; ixodes hexagonus; ixodes pavlovskyi; ixodes persulcatus; ixodes ricinus; ixodes uriae; limosa limosa; microtus arvalis; microtus oeconomus; mus musculus; myodes glareolus; myodes rufocanus; myodes rutilus; neotoma floridana; peromyscus gossypinus; picoides pubescens; sicista betulina; trichodectes canis; tringa totanus
borrelia hermsii	Bacteria	5	homo sapiens; odocoileus hemionus; ornithodoros hermsi; strix occidentalis; tamiasciurus hudsonicus
borrelia hispanica	Bacteria	2	homo sapiens; ornithodoros erraticus
borrelia miyamotoi	Bacteria	5	homo sapiens; ixodes persulcatus; ixodes ricinus; ixodes scapularis; meleagris gallopavo
borrelia persica	Bacteria	4	canis lupus; canis lupus familiaris; felis catus; homo sapiens
borrelia recurrentis	Bacteria	1	homo sapiens
borrelia spielmanii	Bacteria	3	homo sapiens; ixodes ricinus; vulpes vulpes
bothriocephalus acheilognathi	Helminth	23	abbottina rivularis; andinoacara coeruleopunctatus; chanodichthys dabryi; chanodichthys erythropterus; coreius guichenoti; ctenopharyngodon idella; culter alburnus; cyprinus carpio; gambusia affinis; gnathopogon imberbis; hemiculter bleekeri; hemiculter leucisculus; homo sapiens; labeobarbus nedgia; luciobrama macrocephalus; opsariichthys bidens; poecilia mexicana; poecilia reticulata; schizothorax pseudoaksaiensis; squaliobarbus curriculus; xenophysogobio boulengeri; xiphophorus hellerii; zacco platypus
botryomyces caespitosus	Fungi	1	homo sapiens
botryosphaeria dothidea	Fungi	1	homo sapiens
botryosphaeria rhodina	Fungi	2	homo sapiens; phakellia fusca
bovine papular stomatitis virus	Virus	2	bos taurus; homo sapiens
brachyspira aalborgi	Bacteria	1	homo sapiens
brachyspira pilosicoli	Bacteria	12	anas platyrhynchos; canis lupus; canis lupus familiaris; corvus monedula; gallus gallus; homo sapiens; meleagris gallopavo; mus musculus; rattus norvegicus; struthio camelus; sus scrofa; sus scrofa domesticus
brevibacillus brevis	Bacteria	6	apis mellifera; chionoecetes japonicus; homo sapiens; theobroma cacao; vitis vinifera; zootermopsis angusticollis
brevibacterium casei	Bacteria	3	homo sapiens; oreochromis niloticus; salicornia brachiata
brevibacterium ravenspurgense	Bacteria	1	homo sapiens
brevibacterium sanguinis	Bacteria	2	chionoecetes japonicus; homo sapiens
brevundimonas diminuta	Bacteria	5	allium sativum; cytisus striatus; helicoverpa armigera; homo sapiens; phyllanthus amarus
brevundimonas vesicularis	Bacteria	2	homo sapiens; phaseolus vulgaris
brucella abortus	Bacteria	7	bison bison; bos taurus; bubalus bubalis; camelus dromedarius; cervus elaphus; homo sapiens; sus scrofa
brucella canis	Bacteria	4	bos taurus; canis lupus; canis lupus familiaris; homo sapiens
brucella melitensis	Bacteria	5	bos taurus; capra hircus; capra ibex; homo sapiens; ovis aries
brucella suis	Bacteria	5	bos taurus; equus caballus; homo sapiens; rangifer tarandus; sus scrofa
brugia malayi	Helminth	6	canis lupus; canis lupus familiaris; felis catus; homo sapiens; meriones unguiculatus; presbytis cristata
brugia pahangi	Helminth	5	canis lupus; canis lupus familiaris; felis catus; homo sapiens; meriones unguiculatus
brugia timori	Helminth	1	homo sapiens
bse agent	Virus	1	homo sapiens
buffalopox virus	Virus	3	bos taurus; bubalus bubalis; homo sapiens
bulleidia extructa	Bacteria	1	homo sapiens
bunostomum trigonocephalum	Helminth	4	capra hircus; capreolus capreolus; homo sapiens; ovis aries
bunyamwera virus	Virus	15	anopheles barbirostris; anopheles gambiae; anopheles maculipennis; anopheles quadrimaculatus; anopheles subpictus; bos taurus; culex gelidus; culex pseudovishnui; culex tritaeniorhynchus; culiseta inornata; equus caballus; homo sapiens; mansonia uniformis; ochlerotatus taeniorhynchus; sus scrofa
burkholderia cenocepacia	Bacteria	6	arachis hypogaea; crotalaria pallida; homo sapiens; oryza sativa; oxystelma esculentum; prunus dulcis
burkholderia cepacia	Bacteria	18	acacia decurrens; acacia seyal; allium cepa; catharanthus roseus; dalbergia odorifera; homo sapiens; hymenocallis littoralis; lemna minor; mimosa flocculosa; musa acuminata; oryza sativa; prunus armeniaca; sphagnum fallax; sphagnum magellanicum; suillus variegatus; syzygium cumini; triticum aestivum; zea mays
burkholderia dolosa	Bacteria	1	homo sapiens
burkholderia endofungorum	Bacteria	2	homo sapiens; rhizopus microsporus
burkholderia fungorum	Bacteria	8	capreolus capreolus; homo sapiens; macroptilium atropurpureum; phanerochaete chrysosporium; prunus dulcis; suillus variegatus; sus scrofa; vitis vinifera
burkholderia gladioli	Bacteria	6	ananas comosus; crocus sativus; dracaena reflexa; homo sapiens; oryza sativa; zea mays
burkholderia mallei	Bacteria	2	equus caballus; homo sapiens
burkholderia multivorans	Bacteria	2	homo sapiens; sphagnum magellanicum
burkholderia pseudomallei	Bacteria	7	bos taurus; capra hircus; equus caballus; felis catus; homo sapiens; ovis aries; sus scrofa
burkholderia rhizoxinica	Bacteria	1	homo sapiens
burkholderia stabilis	Bacteria	2	homo sapiens; sarcodon aspratus
burkholderia tropica	Bacteria	10	acacia auriculiformis; ammophila arenaria; ananas comosus; homo sapiens; nypa fruticans; psidium guajava; saccharum officinarum; solanum lycopersicum; sorghum bicolor; zea mays
butyrivibrio fibrisolvens	Bacteria	3	bos taurus; homo sapiens; rangifer tarandus
bwamba virus	Virus	2	aedes circumluteolus; homo sapiens
california encephalitis virus	Virus	21	aedes albopictus; aedes cinereus; aedes vexans; anopheles maculipennis; bos taurus; culex modestus; culiseta inornata; equus caballus; homo sapiens; lepus americanus; ochlerotatus abserratus; ochlerotatus canadensis; ochlerotatus cantans; ochlerotatus caspius; ochlerotatus cataphylla; ochlerotatus communis; ochlerotatus dorsalis; ochlerotatus excrucians; ochlerotatus squamiger; ochlerotatus taeniorhynchus; ochlerotatus triseriatus
calodium hepaticum	Helminth	1	homo sapiens
calyptrozyma arxii	Fungi	1	homo sapiens
camelpox virus	Virus	3	camelus bactrianus; camelus dromedarius; homo sapiens
campylobacter coli	Bacteria	7	bos taurus; gallus gallus; homo sapiens; meleagris gallopavo; ovis aries; sus scrofa; sus scrofa domesticus
campylobacter concisus	Bacteria	1	homo sapiens
campylobacter curvus	Bacteria	1	homo sapiens
campylobacter fetus	Bacteria	7	bos taurus; canis lupus familiaris; equus caballus; homo sapiens; ovis aries; sus scrofa; sus scrofa domesticus
campylobacter gracilis	Bacteria	1	homo sapiens
campylobacter hominis	Bacteria	1	homo sapiens
campylobacter hyointestinalis	Bacteria	5	bos taurus; homo sapiens; ovis aries; sus scrofa; sus scrofa domesticus
campylobacter insulaenigrae	Bacteria	1	homo sapiens
campylobacter jejuni	Bacteria	12	bos taurus; canis lupus familiaris; capra hircus; equus caballus; felis catus; gallus gallus; homo sapiens; macaca mulatta; meleagris gallopavo; ovis aries; sus scrofa; sus scrofa domesticus
campylobacter lari	Bacteria	1	homo sapiens
campylobacter rectus	Bacteria	1	homo sapiens
campylobacter showae	Bacteria	1	homo sapiens
campylobacter sputorum	Bacteria	2	bos taurus; homo sapiens
campylobacter upsaliensis	Bacteria	3	canis lupus familiaris; felis catus; homo sapiens
candida aaseri	Fungi	1	homo sapiens
candida albicans	Fungi	15	bos taurus; canis lupus; canis lupus familiaris; capra hircus; equus caballus; felis catus; homo sapiens; macrobrachium rosenbergii; ovis aries; pseudorca crassidens; steno bredanensis; sus scrofa; sus scrofa domesticus; tursiops aduncus; tursiops truncatus
candida bracarensis	Fungi	1	homo sapiens
candida catenulata	Fungi	1	homo sapiens
candida dubliniensis	Fungi	1	homo sapiens
candida ethanolica	Fungi	1	homo sapiens
candida famata	Fungi	1	homo sapiens
candida glabrata	Fungi	3	bos taurus; homo sapiens; tursiops aduncus
candida haemulonis	Fungi	1	homo sapiens
candida inconspicua	Fungi	1	homo sapiens
candida intermedia	Fungi	1	homo sapiens
candida kruisii	Fungi	1	homo sapiens
candida membranifaciens	Fungi	1	homo sapiens
candida metapsilosis	Fungi	1	homo sapiens
candida nivariensis	Fungi	1	homo sapiens
candida orthopsilosis	Fungi	1	homo sapiens
candida palmioleophila	Fungi	1	homo sapiens
candida parapsilosis	Fungi	4	bos taurus; felis catus; homo sapiens; phakellia fusca
candida rugosa	Fungi	1	homo sapiens
candida tropicalis	Fungi	4	bos taurus; homo sapiens; pseudorca crassidens; tursiops truncatus
candida zeylanoides	Fungi	3	eubalaena australis; homo sapiens; orgyia pseudotsugata
capnocytophaga canimorsus	Bacteria	4	canis lupus; canis lupus familiaris; felis catus; homo sapiens
capnocytophaga gingivalis	Bacteria	1	homo sapiens
capnocytophaga granulosa	Bacteria	1	homo sapiens
capnocytophaga ochracea	Bacteria	1	homo sapiens
capnocytophaga sputigena	Bacteria	1	homo sapiens
capronia semiimmersa	Fungi	1	homo sapiens
caraparu virus	Virus	3	cebus apella; culex portesi; homo sapiens
cardiobacterium hominis	Bacteria	1	homo sapiens
cardiobacterium valvarum	Bacteria	1	homo sapiens
carnobacterium divergens	Bacteria	2	homo sapiens; oncorhynchus mykiss
catenulostroma abietis	Fungi	1	homo sapiens
catenulostroma chromoblastomycosum	Fungi	1	homo sapiens
catonella morbi	Bacteria	1	homo sapiens
cedecea davisae	Bacteria	4	aloe vera; ctenopharyngodon idella; homo sapiens; plutella xylostella
cellulosimicrobium cellulans	Bacteria	5	dendroctonus valens; helicoverpa armigera; homo sapiens; paeonia ostii; vigna mungo
cellulosimicrobium funkei	Bacteria	2	anas platyrhynchos; homo sapiens
cellvibrio mixtus	Bacteria	1	homo sapiens
centipeda periodontii	Bacteria	1	homo sapiens
centrocestus armatus	Helminth	1	homo sapiens
centrocestus formosanus	Helminth	1	homo sapiens
cephalotheca foveolata	Fungi	1	homo sapiens
cercopithecine herpesvirus 5	Virus	2	chlorocebus aethiops; homo sapiens
ceriporia lacerata	Fungi	1	homo sapiens
chaetomium atrobrunneum	Fungi	1	homo sapiens
chaetomium brasiliense	Fungi	1	homo sapiens
chaetomium globosum	Fungi	3	canis lupus; canis lupus familiaris; homo sapiens
chalastospora gossypii	Fungi	1	homo sapiens
chandipura virus	Virus	1	homo sapiens
chapare virus	Virus	1	homo sapiens
chikungunya virus	Virus	7	aedes aegypti; aedes africanus; aedes albopictus; aedes furcifer; aedes luteocephalus; homo sapiens; macaca fascicularis
chilomastix mesnili	Protozoa	1	homo sapiens
chlamydia trachomatis	Bacteria	3	homo sapiens; sus scrofa; sus scrofa domesticus
chlamydophila abortus	Bacteria	11	bitis arietans; bos taurus; bubalus bubalis; capra hircus; chelonia mydas; ciconia boyciana; homo sapiens; melopsittacus undulatus; ovis aries; python molurus; sus scrofa
chlamydophila felis	Bacteria	3	felis catus; homo sapiens; iguana iguana
chlamydophila pneumoniae	Bacteria	12	bitis arietans; chamaeleo dilepis; chelonia mydas; cryptothylax greshoffii; equus caballus; homo sapiens; iguana iguana; litoria citropa; perameles bougainville; phascolarctos cinereus; potorous gilbertii; rana temporaria
chlamydophila psittaci	Bacteria	43	amazona aestiva; anas platyrhynchos; ara severa; aratinga acuticaudata; aratinga aurea; aratinga jandaya; aratinga pertinax; bos taurus; cacatua moluccensis; cacatua sulphurea; canis lupus familiaris; capra hircus; ciconia boyciana; columba livia; corvus cornix; diuca diuca; felis catus; fulmarus glacialis; homo sapiens; lorius lory; meleagris gallopavo; melopsittacus undulatus; nymphicus hollandicus; ovis aries; padda oryzivora; paroaria coronata; pionites leucogaster; pionites melanocephala; poicephalus cryptoxanthus; poicephalus gulielmi; poicephalus meyeri; poicephalus senegalus; primolius auricollis; psittacula derbiana; psittacula eupatria; psittacus erithacus; pyrrhura perlata; serinus canaria; sterna hirundo; struthio camelus; sus scrofa; trichoglossus haematodus; turdus amaurochalinus
'chlorella' saccharophila	Green algae	1	homo sapiens
chromobacterium violaceum	Bacteria	2	felis catus; homo sapiens
chryseobacterium indologenes	Bacteria	2	anopheles stephensi; homo sapiens
citrobacter braakii	Bacteria	6	carassius auratus; ctenopharyngodon idella; culex quinquefasciatus; daucus carota; homo sapiens; oncorhynchus mykiss
citrobacter freundii	Bacteria	12	anopheles stephensi; apis mellifera; arion lusitanicus; culex quinquefasciatus; cyprinus carpio; eriocheir sinensis; gallus gallus; homo sapiens; macrobrachium rosenbergii; musa acuminata; pelodiscus sinensis; vitis vinifera
citrobacter gillenii	Bacteria	4	arion lusitanicus; helix pomatia; homo sapiens; oncorhynchus mykiss
citrobacter koseri	Bacteria	2	homo sapiens; phoenix canariensis
citrobacter rodentium	Bacteria	1	homo sapiens
cjd agent	Virus	1	homo sapiens
cladophialophora bantiana	Fungi	2	felis catus; homo sapiens
cladophialophora carrionii	Fungi	2	homo sapiens; lagenorhynchus obliquidens
cladophialophora devriesii	Fungi	1	homo sapiens
cladorrhinum bulbillosum	Fungi	1	homo sapiens
cladosporium bruhnei	Fungi	1	homo sapiens
cladosporium cladosporioides	Fungi	8	canis lupus; canis lupus familiaris; diaphorina citri; gorgonia ventalina; homo sapiens; ixodes scapularis; membranipora membranacea; oribatula tibialis
cladosporium cucumerinum	Fungi	1	homo sapiens
cladosporium oxysporum	Fungi	1	homo sapiens
cladosporium sphaerospermum	Fungi	2	homo sapiens; membranipora membranacea
cladosporium velox	Fungi	1	homo sapiens
clavispora lusitaniae	Fungi	1	homo sapiens
clinostomum complanatum	Helminth	5	barbus barbus; barbus meridionalis; homo sapiens; lepomis gibbosus; squalius cephalus
cloacibacillus evryensis	Bacteria	1	homo sapiens
clonorchis sinensis	Helminth	6	canis lupus; canis lupus familiaris; felis catus; homo sapiens; prionailurus bengalensis; sus scrofa
clostridium baratii	Bacteria	1	homo sapiens
clostridium botulinum	Bacteria	12	anas platyrhynchos; bos taurus; canis lupus familiaris; capra hircus; equus caballus; haliaeetus leucocephalus; homo sapiens; neogobius melanostomus; oncorhynchus mykiss; ovis aries; sus scrofa; sus scrofa domesticus
clostridium butyricum	Bacteria	2	eisenia fetida; homo sapiens
clostridium celerecrescens	Bacteria	2	eisenia fetida; homo sapiens
clostridium clostridioforme	Bacteria	1	homo sapiens
clostridium difficile	Bacteria	7	canis lupus; canis lupus familiaris; equus caballus; homo sapiens; mesocricetus auratus; sus scrofa; sus scrofa domesticus
clostridium hiranonis	Bacteria	3	canis lupus; canis lupus familiaris; homo sapiens
clostridium histolyticum	Bacteria	4	bos taurus; homo sapiens; sus scrofa; sus scrofa domesticus
clostridium hylemonae	Bacteria	1	homo sapiens
clostridium innocuum	Bacteria	2	homo sapiens; mus musculus
clostridium novyi	Bacteria	6	bos taurus; equus caballus; gallus gallus; homo sapiens; ovis aries; sus scrofa
clostridium perfringens	Bacteria	13	alphitobius diaperinus; bos taurus; canis lupus familiaris; capra hircus; capreolus capreolus; equus caballus; felis catus; gallus gallus; homo sapiens; meleagris gallopavo; ovis aries; sus scrofa; sus scrofa domesticus
clostridium ramosum	Bacteria	1	homo sapiens
clostridium septicum	Bacteria	6	bos taurus; gallus gallus; homo sapiens; meleagris gallopavo; ovis aries; sus scrofa
clostridium sordellii	Bacteria	3	bos taurus; homo sapiens; ovis aries
clostridium sporogenes	Bacteria	3	bos taurus; homo sapiens; sus scrofa
clostridium tetani	Bacteria	5	bos taurus; equus caballus; homo sapiens; ovis aries; sus scrofa
coccidioides immitis	Fungi	6	canis lupus familiaris; capra hircus; equus caballus; felis catus; homo sapiens; sus scrofa
coccidioides posadasii	Fungi	2	homo sapiens; lama glama
cochliobolus australiensis	Fungi	5	bromus catharticus; chloris gayana; homo sapiens; jatropha curcas; oryza sativa
cochliobolus cynodontis	Fungi	1	homo sapiens
cochliobolus geniculatus	Fungi	6	homo sapiens; oryza sativa; zea mays; zoysia japonica; zoysia matrella; zoysia tenuifolia
cochliobolus hawaiiensis	Fungi	1	homo sapiens
cochliobolus lunatus	Fungi	1	homo sapiens
cochliobolus spicifer	Fungi	1	homo sapiens
cochliobolus verruculosus	Fungi	4	chamaedorea elegans; homo sapiens; paullinia cupana; triticum aestivum
cokeromyces recurvatus	Fungi	1	homo sapiens
colletotrichum dematium	Fungi	26	aeschynomene americana; amorphophallus muelleri; crotalaria spectabilis; eryngium campestre; genista tinctoria; goniolimon tataricum; homo sapiens; hosta sieboldiana; hydrangea macrophylla; medicago sativa; nicotiana tabacum; ophiopogon japonicus; passiflora edulis; persicaria pensylvanica; peucedanum praeruptorum; phaseolus lunatus; phytolacca acinosa; polygonatum falcatum; prunella vulgaris; reineckea carnea; satyrium nepalense; solanum tuberosum; sphagneticola trilobata; trillium viride; vitis vinifera; xanthium strumarium
colletotrichum gloeosporioides	Fungi	129	achyranthes aspera; aegle marmelos; allium cepa; annona cherimola; annona muricata; annona squamosa; aquilaria sinensis; arachis hypogaea; areca catechu; artemisia argyi; artemisia vulgaris; averrhoa carambola; azadirachta indica; bambusa bambos; barringtonia acutangula; calamagrostis x acutiflora; calathea plurispicata; calophyllum inophyllum; camellia oleifera; camellia sinensis; capsicum annuum; carica papaya; carya illinoinensis; cassia fistula; catharanthus roseus; chrysanthemum indicum; citrus aurantiifolia; citrus aurantium; citrus latifolia; citrus limon; citrus maxima; citrus reticulata; citrus sinensis; cocos nucifera; coffea arabica; coffea canephora; copernicia prunifera; cucumis sativus; cucurbita maxima; curcuma longa; cymbidium ensifolium; cymbidium sinense; dalbergia odorifera; datura metel; dendrobium thyrsiflorum; dianella caerulea; dioscorea alata; dioscorea polystachya; diospyros ferrea; diospyros kaki; dracaena cambodiana; eclipta prostrata; elaeis guineensis; elettaria cardamomum; eriobotrya japonica; erythrina variegata; euonymus japonicus; excoecaria agallocha; ficus carica; forsythia suspensa; fragaria x ananassa; fraxinus excelsior; glycine max; grevillea robusta; hemerocallis fulva; hevea brasiliensis; holcoglossum lingulatum; homo sapiens; hoya carnosa; huperzia crispata; huperzia serrata; hylocereus undatus; hypericum japonicum; jasminum sambac; jatropha curcas; juglans regia; lagenaria siceraria; lantana camara; litchi chinensis; malus x domestica; mangifera indica; manihot esculenta; morus alba; musa acuminata; nothapodytes nimmoniana; olea europaea; osmanthus fragrans; pachira macrocarpa; paullinia cupana; persea americana; phedimus kamtschaticus; phlogacanthus thyrsiflorus; pholidota pallida; phytolacca acinosa; piper nigrum; populus deltoides; pourouma tomentosa; psidium guajava; pyrus x bretschneideri; quercus robur; quercus wutaishanica; rheum x hybridum; salsola tragus; saraca asoca; sarracenia minor; sarracenia oreophila; sarracenia psittacina; schefflera actinophylla; smallanthus sonchifolius; solanum betaceum; solanum cernuum; solanum lycopersicum; solanum tuberosum; sphagneticola trilobata; spondias dulcis; syzygium samarangense; taxus x media; tectaria incisa; theobroma cacao; tinospora cordifolia; trichosanthes kirilowii; tripterygium wilfordii; uraria picta; vaccinium corymbosum; vernonia cinerea; viscum album; vitex negundo; vitis heyneana; vitis vinifera
colletotrichum truncatum	Fungi	1	homo sapiens
collinsella aerofaciens	Bacteria	1	homo sapiens
collinsella intestinalis	Bacteria	1	homo sapiens
comamonas testosteroni	Bacteria	1	homo sapiens
conidiobolus coronatus	Fungi	2	equus caballus; homo sapiens
conidiobolus incongruus	Fungi	1	homo sapiens
conidiobolus lamprauges	Fungi	2	homo sapiens; ovis aries
coprinellus domesticus	Fungi	1	homo sapiens
coprinopsis cinerea	Fungi	4	eclipta prostrata; grevillea robusta; homo sapiens; syzygium cumini
cordyceps bassiana	Fungi	33	agrilus planipennis; bombyx mori; choristoneura fumiferana; cnaphalocrocis medinalis; cydia pomonella; diabrotica undecimpunctata; diatraea saccharalis; dicladispa armigera; dryocoetes autographus; eldana saccharina; euproctis chrysorhoea; euschistus heros; galleria mellonella; homo sapiens; hylurgops palliatus; hylurgus ligniperda; hyphantria cunea; hypothenemus hampei; ips sexdentatus; ips typographus; ixodes ricinus; leptinotarsa decemlineata; monochamus alternatus; monochamus saltuarius; nilaparvata lugens; pentalonia nigronervosa; pieris rapae; polistes jokahamae; reticulitermes flavipes; scyphophorus acupunctatus; sesamia inferens; sitona discoideus; spodoptera litura
cordylobia anthropophaga	Arthropod	3	canis lupus; canis lupus familiaris; homo sapiens
corynascus kuwaitiensis	Fungi	1	homo sapiens
corynebacterium afermentans	Bacteria	2	homo sapiens; pseudopterogorgia elisabethae
corynebacterium amycolatum	Bacteria	2	homo sapiens; musa acuminata
corynebacterium argentoratense	Bacteria	1	homo sapiens
corynebacterium atypicum	Bacteria	1	homo sapiens
corynebacterium bovis	Bacteria	3	bos taurus; homo sapiens; mus musculus
corynebacterium diphtheriae	Bacteria	2	brassica rapa; homo sapiens
corynebacterium durum	Bacteria	1	homo sapiens
corynebacterium freiburgense	Bacteria	1	homo sapiens
corynebacterium jeikeium	Bacteria	1	homo sapiens
corynebacterium kroppenstedtii	Bacteria	1	homo sapiens
corynebacterium macginleyi	Bacteria	1	homo sapiens
corynebacterium massiliense	Bacteria	1	homo sapiens
corynebacterium mastitidis	Bacteria	1	homo sapiens
corynebacterium matruchotii	Bacteria	1	homo sapiens
corynebacterium propinquum	Bacteria	1	homo sapiens
corynebacterium pseudodiphtheriticum	Bacteria	1	homo sapiens
corynebacterium pseudotuberculosis	Bacteria	6	bos taurus; camelus dromedarius; capra hircus; equus caballus; homo sapiens; ovis aries
corynebacterium pyruviciproducens	Bacteria	1	homo sapiens
corynebacterium riegelii	Bacteria	1	homo sapiens
corynebacterium simulans	Bacteria	1	homo sapiens
corynebacterium stationis	Bacteria	1	homo sapiens
corynebacterium striatum	Bacteria	1	homo sapiens
corynebacterium tuberculostearicum	Bacteria	1	homo sapiens
corynebacterium ulcerans	Bacteria	5	canis lupus; canis lupus familiaris; felis catus; homo sapiens; sus scrofa
corynebacterium urealyticum	Bacteria	1	homo sapiens
corynebacterium ureicelerivorans	Bacteria	1	homo sapiens
corynebacterium xerosis	Bacteria	2	homo sapiens; sus scrofa
cowpox virus	Virus	21	acinonyx jubatus; ailurus fulgens; apodemus agrarius; apodemus flavicollis; apodemus sylvaticus; bos taurus; callithrix jacchus; canis lupus; canis lupus familiaris; equus caballus; felis catus; homo sapiens; lama glama; loxodonta africana; lynx lynx; microtus agrestis; microtus arvalis; microtus socialis; mus musculus; myodes glareolus; rattus norvegicus
coxiella burnetii	Bacteria	18	argas persicus; bos taurus; bubalus bubalis; capra hircus; dermacentor reticulatus; felis catus; haemaphysalis concinna; haemaphysalis punctata; homo sapiens; hyalomma anatolicum; ixodes ricinus; ovis aries; perameles bougainville; rattus norvegicus; rhipicephalus bursa; rhipicephalus sanguineus; rhipicephalus turanicus; sus scrofa
crimean-congo hemorrhagic fever virus	Virus	15	argas reflexus; bos taurus; capra hircus; homo sapiens; hyalomma anatolicum; hyalomma asiaticum; hyalomma detritum; hyalomma excavatum; hyalomma impeltatum; hyalomma truncatum; ovis aries; rattus norvegicus; rhipicephalus annulatus; rhipicephalus bursa; rhipicephalus sanguineus
cronobacter malonaticus	Bacteria	1	homo sapiens
cronobacter sakazakii	Bacteria	16	allamanda cathartica; anopheles stephensi; capra hircus; catharanthus roseus; cyrtostachys renda; elaeis guineensis; ficus deltoidea; homo sapiens; ixora coccinea; lantana camara; mammillaria fraileana; oryza sativa; piper betle; salicornia brachiata; stomoxys calcitrans; tridax procumbens
cronobacter turicensis	Bacteria	1	homo sapiens
cryptendoxyla hypophloia	Fungi	1	homo sapiens
cryptobacterium curtum	Bacteria	1	homo sapiens
cryptococcus curvatus	Fungi	1	homo sapiens
cryptococcus gattii	Fungi	3	acinonyx jubatus; capra hircus; homo sapiens
cryptococcus laurentii	Fungi	1	homo sapiens
cryptococcus neoformans	Fungi	12	bos taurus; canis lupus familiaris; capra hircus; columba livia; equus caballus; eubalaena australis; felis catus; homo sapiens; mus musculus; ovis aries; sus scrofa; sus scrofa domesticus
cryptosporidium andersoni	Protozoa	8	bos taurus; bubalus bubalis; camelus bactrianus; camelus dromedarius; capra hircus; homo sapiens; mesocricetus auratus; ovis aries
cryptosporidium bovis	Protozoa	5	bos grunniens; bos taurus; capra hircus; homo sapiens; ovis aries
cryptosporidium canis	Protozoa	4	canis latrans; canis lupus; canis lupus familiaris; homo sapiens
cryptosporidium cuniculus	Protozoa	2	homo sapiens; oryctolagus cuniculus
cryptosporidium fayeri	Protozoa	5	homo sapiens; macropus giganteus; perameles bougainville; petrogale xanthopus; phascolarctos cinereus
cryptosporidium felis	Protozoa	3	felis catus; felis silvestris; homo sapiens
cryptosporidium hominis	Protozoa	5	bos taurus; capra hircus; homo sapiens; macaca mulatta; ovis aries
cryptosporidium meleagridis	Protozoa	8	canis lupus; canis lupus familiaris; gallus gallus; homo sapiens; meleagris gallopavo; nymphicus hollandicus; phoenicopterus chilensis; psittacula krameri
cryptosporidium muris	Protozoa	22	apodemus speciosus; bos taurus; camelus bactrianus; camelus dromedarius; canis lupus; canis lupus familiaris; felis catus; giraffa camelopardalis; homo sapiens; mus musculus; oreamnos americanus; pantherophis guttatus; podargus strigoides; procavia capensis; pusa hispida; python regius; rattus norvegicus; rattus rattus; struthio camelus; sus scrofa; tachyoryctes splendens; tamias sibiricus
cryptosporidium parvum	Protozoa	57	anas platyrhynchos; apodemus flavicollis; apodemus sylvaticus; bos taurus; bubalus bubalis; canis lupus; canis lupus familiaris; capra hircus; cebus apella; cervus elaphus; cervus nippon; chamelea gallina; cheilodactylus variegatus; coturnix japonica; dolichotis patagonum; dugong dugon; equus asinus; equus caballus; erinaceus europaeus; eublepharis macularius; felis catus; fulica atra; galictis cuja; gallus gallus; hippotragus niger; homo sapiens; iguana iguana; lagothrix lagotricha; lama glama; lama pacos; larus dominicanus; macaca mulatta; macaca sinica; macropus rufus; meleagris gallopavo; microtus arvalis; mus musculus; mustela putorius; mustela putorius furo; myocastor coypus; myodes glareolus; mytilus edulis; nymphicus hollandicus; oryctolagus cuniculus; ovis aries; panthera tigris; pantherophis guttatus; papio hamadryas; phascolarctos cinereus; phasianus colchicus; procyon lotor; pterocnemia pennata; semnopithecus entellus; sus scrofa; sus scrofa domesticus; trachypithecus vetulus; zalophus californianus
cryptosporidium ubiquitum	Protozoa	6	bos taurus; capra hircus; coendou prehensilis; homo sapiens; mus musculus; ovis aries
culex quinquefasciatus	Arthropod	1	homo sapiens
cunninghamella bertholletiae	Fungi	1	homo sapiens
cupriavidus basilensis	Bacteria	1	homo sapiens
cupriavidus taiwanensis	Bacteria	5	homo sapiens; mimosa diplotricha; mimosa pigra; mimosa pudica; paeonia ostii
curvularia lunata	Fungi	19	colocasia esculenta; crotalaria juncea; cucumis sativus; echinochloa crus-galli; echinodorus scaber; fragaria x ananassa; halodule pinifolia; homo sapiens; luehea divaricata; lycium chinense; oryza sativa; pterocarpus santalinus; setaria italica; solanum tuberosum; sorghum bicolor; syzygium cumini; theobroma cacao; triticum aestivum; zea mays
cyberlindnera jadinii	Fungi	1	homo sapiens
cyclospora cayetanensis	Protozoa	1	homo sapiens
cyphellophora laciniata	Fungi	1	homo sapiens
cystoisospora belli	Protozoa	1	homo sapiens
debaryomyces fabryi	Fungi	1	homo sapiens
debaryomyces hansenii	Fungi	2	homo sapiens; oncorhynchus mykiss
debaryomyces subglobosus	Fungi	1	homo sapiens
delftia acidovorans	Bacteria	6	anguilla anguilla; bactrocera tau; brassica napus; homo sapiens; saccharum officinarum; sphagnum magellanicum
delftia tsuruhatensis	Bacteria	5	acropora digitifera; brassica napus; homo sapiens; oreochromis niloticus; phaseolus vulgaris
demodex brevis	Arthropod	1	homo sapiens
demodex folliculorum	Arthropod	1	homo sapiens
dengue virus	Virus	8	aedes aegypti; aedes albopictus; carollia perspicillata; didelphis marsupialis; homo sapiens; marmosa murina; mus musculus; proechimys cuvieri
dermatophilus congolensis	Bacteria	8	bos indicus; bos taurus; camelus dromedarius; capra hircus; equus caballus; homo sapiens; ovis aries; sus scrofa
desmospora activa	Bacteria	1	homo sapiens
desulfomicrobium orale	Bacteria	1	homo sapiens
desulfovibrio piger	Bacteria	1	homo sapiens
dialister invisus	Bacteria	1	homo sapiens
dialister micraerophilus	Bacteria	1	homo sapiens
dialister pneumosintes	Bacteria	1	homo sapiens
dialister succinatiphilus	Bacteria	1	homo sapiens
diaphorobacter nitroreducens	Bacteria	1	homo sapiens
dicrocoelium dendriticum	Helminth	5	bos taurus; capra hircus; homo sapiens; ovis aries; sus scrofa
dictyostelium discoideum	Protozoa	1	homo sapiens
dictyostelium polycephalum	Protozoa	1	homo sapiens
dientamoeba fragilis	Protozoa	1	homo sapiens
dietzia maris	Bacteria	1	homo sapiens
dietzia natronolimnaea	Bacteria	2	brassica rapa; homo sapiens
dietzia timorensis	Bacteria	1	homo sapiens
dioctophyme renale	Helminth	4	canis lupus familiaris; homo sapiens; neovison vison; rattus norvegicus
diphyllobothrium dendriticum	Helminth	6	coregonus autumnalis; coregonus lavaretus; homo sapiens; larus ridibundus; salvelinus alpinus; salvelinus leucomaenis
diphyllobothrium latum	Helminth	4	canis lupus familiaris; gymnocephalus cernuus; homo sapiens; perca fluviatilis
diphyllobothrium nihonkaiense	Helminth	4	canis lupus; homo sapiens; oncorhynchus keta; oncorhynchus masou
diphyllobothrium pacificum	Helminth	1	homo sapiens
diplogonoporus balaenopterae	Helminth	1	homo sapiens
diplogonoporus grandis	Helminth	1	homo sapiens
dipodascus capitatus	Fungi	1	homo sapiens
dipylidium caninum	Helminth	6	canis lupus; canis lupus familiaris; ctenocephalides felis; felis catus; homo sapiens; vulpes vulpes
dirofilaria immitis	Helminth	14	aedes aegypti; ailurus fulgens; canis latrans; canis lupus; canis lupus familiaris; culex pipiens; felis catus; homo sapiens; mustela putorius; mustela putorius furo; nyctereutes procyonoides; spheniscus humboldti; urocyon cinereoargenteus; vulpes vulpes
dirofilaria repens	Helminth	4	canis lupus; canis lupus familiaris; felis catus; homo sapiens
dirofilaria tenuis	Helminth	1	homo sapiens
dobrava-belgrade virus	Virus	10	apodemus agrarius; apodemus flavicollis; apodemus ponticus; apodemus sylvaticus; homo sapiens; meriones tamariscinus; microtus arvalis; mus musculus; myodes glareolus; sorex araneus
dokdonella koreensis	Bacteria	1	homo sapiens
dolosigranulum pigrum	Bacteria	1	homo sapiens
dorea formicigenerans	Bacteria	1	homo sapiens
dorea longicatena	Bacteria	1	homo sapiens
dracunculus medinensis	Helminth	3	bos taurus; canis lupus familiaris; homo sapiens
dugbe virus	Virus	7	amblyomma gemma; amblyomma lepidum; amblyomma variegatum; bos taurus; homo sapiens; ovis aries; rhipicephalus pulchellus
duvenhage virus	Virus	1	homo sapiens
eastern equine encephalitis virus	Virus	23	bos taurus; coquillettidia perturbans; corvus brachyrhynchos; culex erraticus; culex nigripalpus; culex restuans; culex salinarius; culiseta melanura; culiseta morsitans; cyanocitta cristata; equus caballus; haliaeetus leucocephalus; homo sapiens; melospiza melodia; ochlerotatus canadensis; passerina cyanea; phoca vitulina; quiscalus quiscula; sus scrofa; thryothorus ludovicianus; vireo griseus; vireo olivaceus; zenaida macroura
echinochasmus japonicus	Helminth	1	homo sapiens
echinococcus canadensis	Helminth	14	alces alces; alces americanus; bos taurus; camelus bactrianus; camelus dromedarius; canis lupus; canis lupus familiaris; capra hircus; cervus elaphus; homo sapiens; ovis aries; rangifer tarandus; sus scrofa; sus scrofa domesticus
echinococcus granulosus	Helminth	18	alces alces; bos grunniens; bos taurus; bubalus bubalis; camelus bactrianus; camelus dromedarius; canis aureus; canis lupus; canis lupus familiaris; capra hircus; equus caballus; felis silvestris; homo sapiens; lama pacos; meriones unguiculatus; ovis aries; ovis orientalis; sus scrofa
echinococcus multilocularis	Helminth	13	alopex lagopus; canis latrans; canis lupus; canis lupus familiaris; castor fiber; homo sapiens; meriones unguiculatus; microtus arvalis; microtus richardsoni; myodes rufocanus; nyctereutes procyonoides; ochotona curzoniae; vulpes vulpes
echinococcus oligarthrus	Helminth	1	homo sapiens
echinococcus vogeli	Helminth	3	canis lupus familiaris; equus caballus; homo sapiens
echinoparyphium recurvatum	Helminth	2	homo sapiens; radix peregra
echinostoma cinetorchis	Helminth	1	homo sapiens
echinostoma hortense	Helminth	1	homo sapiens
echinostoma ilocanum	Helminth	1	homo sapiens
echinostoma revolutum	Helminth	9	homo sapiens; lymnaea stagnalis; mesocricetus auratus; ondatra zibethicus; planorbella trivolvis; radix auricularia; radix peregra; stagnicola elodes; stagnicola palustris
edwardsiella tarda	Bacteria	13	anguilla anguilla; anguilla japonica; channa maculata; clarias gariepinus; homo sapiens; monopterus albus; oreochromis niloticus; pangasianodon hypophthalmus; paralichthys olivaceus; pelodiscus sinensis; scophthalmus maximus; silurus asotus; trichogaster pectoralis
eggerthella lenta	Bacteria	1	homo sapiens
ehrlichia canis	Bacteria	12	canis lupus; canis lupus familiaris; didelphis albiventris; felis catus; herpailurus yaguarondi; homo sapiens; leopardus pardalis; leopardus tigrinus; panthera onca; puma concolor; rhipicephalus sanguineus; vulpes vulpes
ehrlichia chaffeensis	Bacteria	15	amblyomma americanum; amblyomma parvum; apodemus agrarius; blastoceros dichotomus; canis lupus; canis lupus familiaris; equus caballus; haemaphysalis longicornis; homo sapiens; ixodes persulcatus; mazama gouazoupira; odocoileus virginianus; ovis aries; procyon lotor; rhipicephalus sanguineus
ehrlichia ewingii	Bacteria	6	amblyomma americanum; canis lupus; canis lupus familiaris; didelphis albiventris; homo sapiens; rhipicephalus sanguineus
ehrlichia ruminantium	Bacteria	12	amblyomma gemma; amblyomma hebraeum; amblyomma lepidum; amblyomma variegatum; bos taurus; capra hircus; didelphis albiventris; homo sapiens; hyalomma truncatum; ovis aries; rhipicephalus evertsi; syncerus caffer
eikenella corrodens	Bacteria	3	canis lupus familiaris; felis catus; homo sapiens
elizabethkingia meningoseptica	Bacteria	5	anopheles gambiae; anopheles stephensi; culex quinquefasciatus; homo sapiens; rana catesbeiana
emericella nidulans	Fungi	2	electra pilosa; homo sapiens
emericella quadrilineata	Fungi	1	homo sapiens
emericella rugulosa	Fungi	1	homo sapiens
emmonsia crescens	Fungi	1	homo sapiens
emmonsia parva	Fungi	1	homo sapiens
encephalitozoon cuniculi	Fungi	9	alopex lagopus; bos taurus; canis lupus; canis lupus familiaris; felis catus; homo sapiens; mus musculus; oryctolagus cuniculus; sus scrofa
encephalitozoon hellem	Fungi	6	agapornis roseicollis; cacatua alba; eclectus roratus; erythrura gouldiae; homo sapiens; struthio camelus
encephalitozoon intestinalis	Fungi	1	homo sapiens
encephalomyocarditis virus	Virus	9	glis glis; homo sapiens; mus musculus; pan paniscus; pan troglodytes; rattus norvegicus; sus scrofa; sus scrofa domesticus; tamiasciurus hudsonicus
engyodontium album	Fungi	1	homo sapiens
entamoeba chattoni	Protozoa	1	homo sapiens
entamoeba coli	Protozoa	5	gorilla gorilla; homo sapiens; macaca fuscata; mandrillus leucophaeus; pan troglodytes
entamoeba dispar	Protozoa	1	homo sapiens
entamoeba hartmanni	Protozoa	5	erythrocebus patas; homo sapiens; lagothrix lagotricha; macaca sylvanus; pongo pygmaeus
entamoeba histolytica	Protozoa	6	canis lupus familiaris; felis catus; homo sapiens; macaca mulatta; meriones unguiculatus; mesocricetus auratus
entamoeba moshkovskii	Protozoa	1	homo sapiens
entamoeba polecki	Protozoa	5	homo sapiens; macaca fascicularis; rhea americana; sus scrofa; sus scrofa domesticus
enterobacter aerogenes	Bacteria	16	bos taurus; bursaphelenchus xylophilus; canis lupus familiaris; coptotermes curvignathus; dendroctonus valens; felis catus; gallus gallus; homo sapiens; macrotermes michaelseni; musa acuminata; musca domestica; ovis aries; saccharum officinarum; sus scrofa; thanatephorus cucumeris; zea mays
enterobacter amnigenus	Bacteria	16	beta vulgaris; canis lupus; canis lupus familiaris; ctenopharyngodon idella; daucus carota; eutrema wasabi; helix pomatia; homo sapiens; medicago sativa; musca domestica; nicotiana attenuata; pleurotus eryngii; rutilus rutilus; solanum tuberosum; vicia faba; vitis vinifera
enterobacter asburiae	Bacteria	7	culex quinquefasciatus; homo sapiens; musa acuminata; musca domestica; nicotiana tabacum; phaseolus vulgaris; zea mays
enterobacter cancerogenus	Bacteria	6	beta vulgaris; culex quinquefasciatus; homo sapiens; hylocereus undatus; medicago sativa; musca domestica
enterobacter cloacae	Bacteria	36	anopheles stephensi; arachis hypogaea; bactrocera zonata; beta vulgaris; bos taurus; canis lupus; canis lupus familiaris; carica papaya; carollia brevicauda; clitoria ternatea; coptotermes curvignathus; culex quinquefasciatus; cyrtostachys renda; elaeis guineensis; equus caballus; etroplus maculatus; felis catus; gallus gallus; glycine max; homo sapiens; hymenocallis littoralis; musa acuminata; musca domestica; nicotiana tabacum; ovis aries; perca fluviatilis; phoenix canariensis; pisum sativum; saccharum officinarum; solanum lycopersicum; sus scrofa; sus scrofa domesticus; taeniopygia guttata; vetiveria zizanioides; zea mays; zingiber officinale
enterobacter hormaechei	Bacteria	13	ananas comosus; anopheles stephensi; anthyllis vulneraria; clitoria ternatea; elaeis guineensis; homo sapiens; oreochromis niloticus; oryza sativa; phaseolus vulgaris; phenacoccus solenopsis; sansevieria trifasciata; tectona grandis; zea mays
enterobacter kobei	Bacteria	1	homo sapiens
enterobacter ludwigii	Bacteria	12	aedes albopictus; arachis hypogaea; bougainvillea spectabilis; brassica napus; bursaphelenchus xylophilus; culex quinquefasciatus; homo sapiens; hymenocallis littoralis; lolium multiflorum; thanatephorus cucumeris; vitis vinifera; zea mays
enterobius gregorii	Helminth	1	homo sapiens
enterobius vermicularis	Helminth	2	homo sapiens; pan troglodytes
enterococcus avium	Bacteria	4	daucus carota; gallus gallus; homo sapiens; sus scrofa
enterococcus casseliflavus	Bacteria	17	apis mellifera; artemia parthenogenetica; boselaphus tragocamelus; capra hircus; corcyra cephalonica; epinephelus awoara; gallus gallus; helicoverpa armigera; homo sapiens; mangifera indica; phaseolus vulgaris; plutella xylostella; rhombomys opimus; sus scrofa; thorectes lusitanicus; upupa epops; vigna mungo
enterococcus durans	Bacteria	8	camelus dromedarius; canis lupus; canis lupus familiaris; gallus gallus; homo sapiens; oryctolagus cuniculus; ovis aries; sus scrofa
enterococcus faecalis	Bacteria	26	acipenser persicus; anas platyrhynchos; anopheles stephensi; apis dorsata; argopecten purpuratus; bos taurus; callinectes sapidus; camelus dromedarius; canis lupus familiaris; capra hircus; culex quinquefasciatus; equus caballus; felis catus; gallus gallus; homo sapiens; lymantria dispar; manduca sexta; musca domestica; naemorhedus goral; oryctolagus cuniculus; ovis aries; panthera tigris; penaeus monodon; rattus norvegicus; sus scrofa; sus scrofa domesticus
enterococcus faecium	Bacteria	20	apis mellifera; bos taurus; camelus dromedarius; canis lupus familiaris; capra hircus; equus caballus; felis catus; gallus gallus; helicoverpa armigera; homo sapiens; mus musculus; oncorhynchus mykiss; oryctolagus cuniculus; ovis aries; pelodiscus sinensis; punica granatum; scophthalmus maximus; sus scrofa; sus scrofa domesticus; thorectes lusitanicus
enterococcus gallinarum	Bacteria	5	culex quinquefasciatus; gallus gallus; helicoverpa armigera; homo sapiens; rattus norvegicus
enterococcus gilvus	Bacteria	1	homo sapiens
enterococcus hawaiiensis	Bacteria	1	homo sapiens
enterococcus hirae	Bacteria	11	anas platyrhynchos; bos taurus; canis lupus; canis lupus familiaris; culex quinquefasciatus; gallus gallus; homo sapiens; lutjanus guttatus; moschus berezovskii; pelodiscus sinensis; sus scrofa
enterococcus italicus	Bacteria	1	homo sapiens
enterococcus mundtii	Bacteria	7	brassica rapa; choristoneura fumiferana; homo sapiens; lymantria dispar; sus scrofa; ulva rigida; zea mays
enterococcus pallens	Bacteria	1	homo sapiens
enterococcus raffinosus	Bacteria	3	camelus dromedarius; helix pomatia; homo sapiens
enterococcus sanguinicola	Bacteria	1	homo sapiens
enterococcus thailandicus	Bacteria	1	homo sapiens
enterocytozoon bieneusi	Fungi	12	bos taurus; canis lupus; canis lupus familiaris; equus caballus; felis catus; homo sapiens; lama glama; macaca mulatta; ondatra zibethicus; procyon lotor; sus scrofa; sus scrofa domesticus
enterovirus c	Virus	4	gorilla gorilla; homo sapiens; mandrillus sphinx; pan troglodytes
epicoccum nigrum	Fungi	2	astacus astacus; homo sapiens
epidermophyton floccosum	Fungi	2	canis lupus familiaris; homo sapiens
erysipelothrix rhusiopathiae	Bacteria	12	bos taurus; canis lupus familiaris; equus caballus; gallus gallus; haliaeetus albicilla; homo sapiens; mustela lutreola; neovison vison; ovis aries; phoca vitulina; sus scrofa; sus scrofa domesticus
erythromicrobium ramosum	Bacteria	1	homo sapiens
escherichia albertii	Bacteria	14	cracticus tibicen; cyanopica cyanus; egretta garzetta; felis catus; gallus gallus; homo sapiens; hypsipetes amaurotis; malurus cyaneus; melithreptus brevirostris; passer montanus; phalacrocorax carbo; puffinus tenuirostris; rhipidura fuliginosa; sturnus cineraceus
escherichia coli	Bacteria	93	ailuropoda melanoleuca; alligator sinensis; anas platyrhynchos; anas poecilorhyncha; anas strepera; antechinus flavipes; anthus campestris; apis cerana; aquila chrysaetos; arion lusitanicus; artemisia annua; asio otus; athene noctua; bonasa bonasia; bos grunniens; bos indicus; bos taurus; branta canadensis; burhinus oedicnemus; camelus dromedarius; canis lupus; canis lupus familiaris; capra hircus; capreolus capreolus; cervus elaphus; chaetodipus penicillatus; choeronycteris mexicana; ciconia ciconia; columba livia; coturnix japonica; culex quinquefasciatus; cyanopica cyanus; dipodomys merriami; emberiza cioides; equus asinus; equus caballus; falco naumanni; felis catus; gallus gallus; hirundo rustica; homo sapiens; hymenocallis littoralis; hypsipetes amaurotis; inachis io; larus argentatus; larus delawarensis; lutjanus guttatus; macaca mulatta; manihot esculenta; meleagris gallopavo; mesocricetus auratus; moschus berezovskii; mus musculus; musca domestica; mustela vison; neotoma albigula; odocoileus virginianus; ornithorhynchus anatinus; oryctolagus cuniculus; otus scops; ovis aries; pandion haliaetus; panthera onca; papio cynocephalus; passer montanus; petaurus breviceps; phalacrocorax carbo; phascolarctos cinereus; philander opossum; phoca vitulina; porphyra yezoensis; puffinus tenuirostris; puma concolor; rattus norvegicus; romerolagus diazi; saguinus oedipus; sarcophilus harrisii; sminthopsis dolichura; spinacia oleracea; streptopelia orientalis; struthio camelus; sturnus cineraceus; sus scrofa; sus scrofa domesticus; tapirus bairdii; tapirus terrestris; thorectes lusitanicus; trachipterus trachypterus; treron sieboldii; tursiops truncatus; ursus arctos; zalophus californianus; zosterops japonicus
eubacterium biforme	Bacteria	1	homo sapiens
eubacterium brachy	Bacteria	1	homo sapiens
eubacterium cylindroides	Bacteria	1	homo sapiens
eubacterium hallii	Bacteria	1	homo sapiens
eubacterium infirmum	Bacteria	3	canis lupus; canis lupus familiaris; homo sapiens
eubacterium limosum	Bacteria	1	homo sapiens
eubacterium minutum	Bacteria	1	homo sapiens
eubacterium nodatum	Bacteria	3	canis lupus; canis lupus familiaris; homo sapiens
eubacterium rectale	Bacteria	1	homo sapiens
eubacterium saburreum	Bacteria	1	homo sapiens
eubacterium saphenum	Bacteria	1	homo sapiens
eubacterium sulci	Bacteria	1	homo sapiens
eubacterium yurii	Bacteria	1	homo sapiens
eucoleus aerophilus	Helminth	4	canis lupus familiaris; felis catus; homo sapiens; vulpes vulpes
european bat lyssavirus 1	Virus	3	eptesicus serotinus; felis catus; homo sapiens
european bat lyssavirus 2	Virus	3	homo sapiens; myotis dasycneme; myotis daubentonii
eurotium amstelodami	Fungi	3	flustra foliacea; homo sapiens; phascolarctos cinereus
eurytrema pancreaticum	Helminth	3	bos indicus; bos taurus; homo sapiens
everglades virus	Virus	1	homo sapiens
ewingella americana	Bacteria	7	agaricus bisporus; bursaphelenchus mucronatus; bursaphelenchus xylophilus; homo sapiens; lyophyllum decastes; pleurotus ostreatus; sialia sialis
exophiala dermatitidis	Fungi	1	homo sapiens
exophiala jeanselmei	Fungi	1	homo sapiens
exophiala phaeomuriformis	Fungi	1	homo sapiens
exophiala spinifera	Fungi	1	homo sapiens
faecalibacterium prausnitzii	Bacteria	1	homo sapiens
fasciola gigantica	Helminth	7	bos indicus; bos primigenius; bos taurus; bubalus bubalis; capra hircus; homo sapiens; ovis aries
fasciola hepatica	Helminth	14	bison bison; bos taurus; bubalus bubalis; camelus bactrianus; camelus dromedarius; capra hircus; capra pyrenaica; cervus elaphus; dama dama; equus caballus; homo sapiens; lymnaea columella; oryctolagus cuniculus; ovis aries
fasciolopsis buski	Helminth	3	homo sapiens; sus scrofa; sus scrofa domesticus
fibricola seoulensis	Helminth	1	homo sapiens
filifactor alocis	Bacteria	1	homo sapiens
finegoldia magna	Bacteria	1	homo sapiens
flavobacterium lindanitolerans	Bacteria	1	homo sapiens
flavonifractor plautii	Bacteria	1	homo sapiens
fluoribacter dumoffii	Bacteria	1	homo sapiens
fonsecaea monophora	Fungi	1	homo sapiens
fonsecaea pedrosoi	Fungi	1	homo sapiens
foot-and-mouth disease virus	Virus	13	aepyceros melampus; bos grunniens; bos indicus; bos taurus; bubalus bubalis; capra hircus; homo sapiens; ovis aries; phacochoerus aethiopicus; potamochoerus porcus; sus scrofa; sus scrofa domesticus; syncerus caffer
francisella philomiragia	Bacteria	1	homo sapiens
francisella tularensis	Bacteria	21	amblyomma americanum; bos taurus; calidris minuta; callithrix jacchus; canis lupus familiaris; cercopithecus diana; dermacentor marginatus; dermacentor reticulatus; dermacentor variabilis; felis catus; haemaphysalis concinna; homo sapiens; hyalomma lusitanicum; ixodes ricinus; lepus europaeus; mus musculus; ovis aries; procambarus clarkii; rhipicephalus sanguineus; sus scrofa; sylvilagus floridanus
fusarium chlamydosporum	Fungi	1	homo sapiens
fusarium falciforme	Fungi	8	caretta caretta; chelonia mydas; dermochelys coriacea; eretmochelys imbricata; homo sapiens; lepidochelys olivacea; natator depressa; solanum tuberosum
fusarium incarnatum	Fungi	13	atractylodes macrocephala; cucumis melo; eclipta prostrata; homo sapiens; juglans regia; oryza sativa; panax ginseng; penaeus monodon; phoenix canariensis; solanum lycopersicum; triticum aestivum; vitis vinifera; zea mays
fusarium napiforme	Fungi	3	homo sapiens; oryza sativa; zea mays
fusarium oxysporum	Fungi	5	acyrthosiphon pisum; homo sapiens; phascolarctos cinereus; philanthus triangulum; tylenchulus semipenetrans
fusarium polyphialidicum	Fungi	1	homo sapiens
fusarium proliferatum	Fungi	54	abelmoschus esculentus; acanthaster planci; actinidia deliciosa; allium cepa; allium fistulosum; allium sativum; allium tuberosum; asparagus officinalis; bruguiera sexangula; carya illinoinensis; cicer arietinum; cycas revoluta; cyperus esculentus; dendrobium moschatum; echinochloa crus-galli; elephas maximus; felis catus; ficus carica; glycine max; hevea brasiliensis; hevea guianensis; homo sapiens; hylocereus undatus; hylurgops palliatus; ipomoea carnea; jatropha curcas; khaya anthotheca; lagenaria siceraria; lilium longiflorum; mangifera indica; morinda citrifolia; nicotiana tabacum; nothapodytes nimmoniana; ophiopogon japonicus; oryza sativa; panax ginseng; pancratium maritimum; paspalum wrightii; phoenix dactylifera; pourouma tomentosa; psidium guajava; robinia pseudoacacia; rumex acetosa; sabal palmetto; solanum lycopersicum; solanum melongena; sorghum bicolor; syagrus romanzoffiana; syzygium samarangense; taxus x media; theobroma cacao; vitis heyneana; vitis vinifera; zea mays
fusarium sacchari	Fungi	5	homo sapiens; nothapodytes nimmoniana; saccharum officinarum; triticum aestivum; zea mays
fusarium solani	Fungi	7	atta texana; caretta caretta; dermochelys coriacea; felis catus; homo sapiens; marsupenaeus japonicus; unidentified nematode
fusarium subglutinans	Fungi	10	ananas comosus; holcus lanatus; homo sapiens; mangifera indica; morinda citrifolia; nicotiana tabacum; nothapodytes nimmoniana; ophiopogon japonicus; orthotomicus erosus; zea mays
fusarium verticillioides	Fungi	37	adansonia gregorii; agave tequilana; apodytes dimidiata; aquilaria crassna; curcuma longa; curcuma wenyujin; dianthus caryophyllus; elaeis guineensis; eleusine coracana; erythrina velutina; ficus carica; fragaria virginiana; glycine max; homo sapiens; huperzia crispata; huperzia selago; hylurgops palliatus; hylurgus ligniperda; ipomoea batatas; jatropha curcas; maxillaria brasiliensis; mikania micrantha; nicotiana tabacum; nothapodytes foetida; nothapodytes nimmoniana; orthotomicus erosus; oryza sativa; phyllanthus amarus; pinus sylvestris; salvia miltiorrhiza; saraca asoca; sesamum indicum; solanum melongena; syzygium cumini; theobroma cacao; triticum aestivum; zea mays
fusobacterium gonidiaformans	Bacteria	1	homo sapiens
fusobacterium naviforme	Bacteria	1	homo sapiens
fusobacterium necrophorum	Bacteria	9	bos taurus; canis lupus familiaris; capra hircus; equus caballus; homo sapiens; ovis aries; rangifer tarandus; sus scrofa; sus scrofa domesticus
fusobacterium nucleatum	Bacteria	2	canis lupus familiaris; homo sapiens
fusobacterium periodonticum	Bacteria	1	homo sapiens
fusobacterium ulcerans	Bacteria	1	homo sapiens
gardnerella vaginalis	Bacteria	1	homo sapiens
gb virus c	Virus	2	homo sapiens; pan troglodytes
gemella haemolysans	Bacteria	1	homo sapiens
gemella morbillorum	Bacteria	1	homo sapiens
gemella sanguinis	Bacteria	1	homo sapiens
geosmithia argillacea	Fungi	1	homo sapiens
giardia intestinalis	Protozoa	69	alces alces; alouatta caraya; alouatta guariba; anas strepera; anser anser; ateles belzebuth; ateles fusciceps; bison bison; bos taurus; bubalus bubalis; callithrix pygmaea; canis latrans; canis lupus; canis lupus familiaris; capra hircus; capreolus capreolus; castor canadensis; cavia porcellus; cercopithecus neglectus; cervus elaphus; chinchilla lanigera; colobus guereza; dama dama; delphinus delphis; dolichotis patagonum; equus caballus; eudorcas thomsonii; eulemur fulvus; eulemur rubriventer; felis catus; gorilla gorilla; halichoerus grypus; hapalemur aureus; homo sapiens; lama pacos; larus argentatus; lemur catta; lynx rufus; macaca fuscata; macaca sylvanus; mandrillus sphinx; mus musculus; mustela putorius; mustela putorius furo; nyctereutes procyonoides; octodon degus; odocoileus virginianus; ondatra zibethicus; oryctolagus cuniculus; oryx leucoryx; ovis aries; pan troglodytes; papio hamadryas; peromyscus maniculatus; phoca vitulina; pithecia pithecia; pusa hispida; rangifer tarandus; rattus norvegicus; saguinus oedipus; saimiri boliviensis; struthio camelus; sus scrofa; sus scrofa domesticus; tamandua tetradactyla; trachypithecus auratus; varecia rubra; varecia variegata; vulpes vulpes
gibberella intermedia	Fungi	3	felis catus; homo sapiens; hylurgops palliatus
gibberella moniliformis	Fungi	4	homo sapiens; hylurgops palliatus; hylurgus ligniperda; orthotomicus erosus
gibbon ape leukemia virus	Virus	2	homo sapiens; lagothrix lagotricha
gnathostoma binucleatum	Helminth	9	cathorops fuerthii; dormitator latifrons; eleotris picta; gobiomorus dormitor; homo sapiens; parachromis managuensis; petenia splendida; rhamdia cinerascens; sciades guatemalensis
gnathostoma doloresi	Helminth	2	homo sapiens; sus scrofa
gnathostoma hispidum	Helminth	1	homo sapiens
gnathostoma nipponicum	Helminth	2	homo sapiens; mustela sibirica
gnathostoma spinigerum	Helminth	4	canis lupus; canis lupus familiaris; felis catus; homo sapiens
gongylonema pulchrum	Helminth	7	bos taurus; cervus nippon; homo sapiens; macaca fuscata; muntiacus reevesi; sus scrofa; sus scrofa leucomystax
gordonia aichiensis	Bacteria	1	homo sapiens
gordonia terrae	Bacteria	1	homo sapiens
granulicatella adiacens	Bacteria	1	homo sapiens
granulicatella elegans	Bacteria	1	homo sapiens
graphium basitruncatum	Fungi	1	homo sapiens
grimontia hollisae	Bacteria	1	homo sapiens
guanarito virus	Virus	2	homo sapiens; zygodontomys brevicauda
guaroa virus	Virus	1	homo sapiens
guggenheimella bovis	Bacteria	1	homo sapiens
haemonchus contortus	Helminth	9	bos taurus; capra hircus; capreolus capreolus; giraffa camelopardalis; homo sapiens; meriones unguiculatus; odocoileus virginianus; ovis aries; rupicapra rupicapra
haemophilus aegyptius	Bacteria	1	homo sapiens
haemophilus ducreyi	Bacteria	1	homo sapiens
haemophilus haemolyticus	Bacteria	1	homo sapiens
haemophilus influenzae	Bacteria	1	homo sapiens
haemophilus parahaemolyticus	Bacteria	1	homo sapiens
haemophilus parainfluenzae	Bacteria	1	homo sapiens
hafnia alvei	Bacteria	6	costelytra zealandica; homo sapiens; salmo trutta; sphagnum fallax; sphagnum magellanicum; thorectes lusitanicus
hantaan virus	Virus	9	apodemus agrarius; apodemus peninsulae; crocidura russula; homo sapiens; mus musculus; niviventer confucianus; rattus nitidus; rattus norvegicus; rattus rattus
haplorchis pumilio	Helminth	10	anabas testudineus; canis lupus; canis lupus familiaris; felis catus; homo sapiens; hypophthalmichthys molitrix; melanoides tuberculata; mus musculus; pangasianodon hypophthalmus; trichogaster trichopterus
haplorchis taichui	Helminth	4	felis catus; homo sapiens; labeo rohita; pangasianodon hypophthalmus
haplorchis yokogawai	Helminth	2	homo sapiens; mystus singaringan
helicobacter cinaedi	Bacteria	2	homo sapiens; macaca mulatta
helicobacter heilmannii	Bacteria	9	acinonyx jubatus; felis catus; homo sapiens; lynx rufus; macaca fascicularis; macaca mulatta; panthera tigris; sarcophilus harrisii; sus scrofa
helicobacter pullorum	Bacteria	3	gallus gallus; homo sapiens; mus musculus
helicobacter pylori	Bacteria	6	canis lupus familiaris; chinchilla lanigera; felis catus; homo sapiens; macaca nemestrina; meriones unguiculatus
hendra virus	Virus	2	equus caballus; homo sapiens
hepatitis a virus	Virus	6	aotus trivirgatus; cercopithecus aethiops; homo sapiens; macaca fascicularis; macaca mulatta; pan troglodytes
hepatitis b virus	Virus	16	bos taurus; chlorocebus aethiops; escherichia coli; forcipomyia taiwana; gorilla beringei; gorilla gorilla; homo sapiens; hylobates agilis; hylobates lar; hylobates pileatus; lagothrix lagotricha; nomascus gabriellae; nomascus leucogenys; pan troglodytes; pongo abelii; pongo pygmaeus
hepatitis c virus	Virus	3	homo sapiens; mus musculus; pan troglodytes
hepatitis delta virus	Virus	1	homo sapiens
hepatitis e virus	Virus	19	balearica pavonina; bos taurus; capreolus capreolus; cervus elaphus; equus caballus; gallus gallus; herpestes javanicus; homo sapiens; lophura nycthemera; macaca mulatta; neofelis nebulosa; oryctolagus cuniculus; ovis aries; panthera tigris; rattus norvegicus; rattus rattus; sus scrofa; sus scrofa domesticus; sus scrofa leucomystax
herminiimonas saxobsidens	Bacteria	1	homo sapiens
heterobilharzia americana	Helminth	5	canis lupus; canis lupus familiaris; equus caballus; homo sapiens; procyon lotor
heterophyes heterophyes	Helminth	3	canis lupus familiaris; felis catus; homo sapiens
heterophyes nocens	Helminth	1	homo sapiens
heterophyopsis continua	Helminth	2	felis catus; homo sapiens
hortaea werneckii	Fungi	2	homo sapiens; membranipora membranacea
human adenovirus a	Virus	1	homo sapiens
human adenovirus b	Virus	2	gorilla gorilla; homo sapiens
human adenovirus c	Virus	6	cichorium intybus; felis catus; homo sapiens; lactuca sativa; pan troglodytes; spinacia oleracea
human adenovirus d	Virus	1	homo sapiens
human adenovirus e	Virus	1	homo sapiens
human adenovirus f	Virus	2	homo sapiens; spinacia oleracea
human adenovirus g	Virus	1	homo sapiens
human astrovirus	Virus	1	homo sapiens
human coronavirus 229e	Virus	1	homo sapiens
human coronavirus hku1	Virus	1	homo sapiens
human coronavirus nl63	Virus	1	homo sapiens
human coronavirus oc43	Virus	1	homo sapiens
human enterovirus 68	Virus	1	homo sapiens
human enterovirus a	Virus	1	homo sapiens
human enterovirus b	Virus	2	homo sapiens; sus scrofa
human enterovirus c	Virus	4	gorilla gorilla; homo sapiens; mandrillus sphinx; pan troglodytes
human enterovirus d	Virus	1	homo sapiens
human herpesvirus 1	Virus	4	callithrix penicillata; homo sapiens; pithecia pithecia; tursiops truncatus
human herpesvirus 2	Virus	1	homo sapiens
human herpesvirus 3	Virus	1	homo sapiens
human herpesvirus 4	Virus	4	canis lupus; canis lupus familiaris; homo sapiens; macaca fascicularis
human herpesvirus 5	Virus	1	homo sapiens
human herpesvirus 6	Virus	2	homo sapiens; pan troglodytes
human herpesvirus 7	Virus	1	homo sapiens
human herpesvirus 8	Virus	7	chlorocebus aethiops; gorilla gorilla; homo sapiens; macaca mulatta; macaca nemestrina; mandrillus sphinx; pan troglodytes
human immunodeficiency virus 1	Virus	4	homo sapiens; macaca mulatta; pan troglodytes; semnopithecus entellus
human immunodeficiency virus 2	Virus	1	homo sapiens
human metapneumovirus	Virus	2	homo sapiens; pan troglodytes
human papillomavirus	Virus	1	homo sapiens
human papillomavirus 10	Virus	1	homo sapiens
human papillomavirus 16	Virus	1	homo sapiens
human papillomavirus 18	Virus	1	homo sapiens
human papillomavirus 26	Virus	1	homo sapiens
human papillomavirus 32	Virus	1	homo sapiens
human papillomavirus 34	Virus	1	homo sapiens
human papillomavirus 4	Virus	1	homo sapiens
human papillomavirus 49	Virus	1	homo sapiens
human papillomavirus 5	Virus	2	homo sapiens; macaca fascicularis
human papillomavirus 53	Virus	1	homo sapiens
human papillomavirus 54	Virus	1	homo sapiens
human papillomavirus 6	Virus	1	homo sapiens
human papillomavirus 61	Virus	1	homo sapiens
human papillomavirus 7	Virus	1	homo sapiens
human papillomavirus 9	Virus	2	felis catus; homo sapiens
human parainfluenza virus 1	Virus	2	homo sapiens; mus musculus
human parainfluenza virus 2	Virus	1	homo sapiens
human parainfluenza virus 3	Virus	2	cavia porcellus; homo sapiens
human parainfluenza virus 4	Virus	1	homo sapiens
human parechovirus	Virus	1	homo sapiens
human parvovirus b19	Virus	1	homo sapiens
human picobirnavirus	Virus	1	homo sapiens
human respiratory syncytial virus	Virus	1	homo sapiens
human rhinovirus a	Virus	1	homo sapiens
human rhinovirus b	Virus	1	homo sapiens
human rhinovirus c	Virus	1	homo sapiens
human t-lymphotropic virus 1	Virus	1	homo sapiens
hymenolepis diminuta	Helminth	4	canis lupus familiaris; homo sapiens; rattus norvegicus; rattus rattus
hymenolepis nana	Helminth	4	homo sapiens; mesocricetus auratus; mus musculus; rattus norvegicus
hyphopichia burtonii	Fungi	2	homo sapiens; mus musculus
ignatzschineria indica	Bacteria	1	homo sapiens
ilheus virus	Virus	1	homo sapiens
infectious spleen and kidney necrosis virus	Virus	25	acanthopagrus latus; colisa lalia; epinephelus coioides; epinephelus fuscoguttatus; epinephelus lanceolatus; epinephelus malabaricus; homo sapiens; larimichthys crocea; lateolabrax japonicus; lates calcarifer; macropodus opercularis; micropterus salmoides; mugil cephalus; oplegnathus fasciatus; oplegnathus punctatus; pagrus major; paralichthys olivaceus; pseudocaranx dentex; pterapogon kauderni; scophthalmus maximus; seriola dumerili; seriola quinqueradiata; siniperca chuatsi; thunnus orientalis; trichogaster leerii
influenza a virus	Virus	165	accipiter trivirgatus; acinonyx jubatus; aechmophorus occidentalis; aix galericulata; aix sponsa; alectoris chukar; alopochen aegyptiacus; anas acuta; anas americana; anas capensis; anas carolinensis; anas castanea; anas clypeata; anas crecca; anas cyanoptera; anas discors; anas formosa; anas penelope; anas platyrhynchos; anas poecilorhyncha; anas querquedula; anas rubripes; anas strepera; anas superciliosa; anser albifrons; anser anser; anser brachyrhynchus; anser caerulescens; anser fabalis; anser indicus; ardea alba; ardea cinerea; arenaria interpres; arenaria melanocephala; aythya americana; aythya collaris; aythya ferina; aythya fuligula; bombycilla cedrorum; branta canadensis; branta leucopsis; bucephala albeola; bucephala clangula; buteo buteo; butorides virescens; cairina moschata; calidris acuminata; calidris alba; calidris alpina; calidris canutus; calidris minutilla; calidris pusilla; calidris ruficollis; canis lupus; canis lupus familiaris; catharus fuscescens; catharus guttatus; catharus ustulatus; cepora nerissa; chlidonias hybridus; chrysolophus pictus; ciconia ciconia; columba livia; contopus sordidulus; corvus frugilegus; corvus monedula; corvus splendens; coturnix japonica; cygnus columbianus; cygnus cygnus; cygnus olor; dendrocygna viduata; dromaius novaehollandiae; empidonax alnorum; empidonax difficilis; equus asinus; equus caballus; equus przewalskii; falco cherrug; falco naumanni; falco peregrinus; falco tinnunculus; felis catus; fulica americana; fulica atra; gallicrex cinerea; gallus gallus; haliaeetus leucocephalus; homo sapiens; icteria virens; inachis io; lanius schach; larus argentatus; larus atricilla; larus brunnicephalus; larus californicus; larus canus; larus delawarensis; larus dominicanus; larus glaucescens; larus hyperboreus; larus ichthyaetus; larus marinus; larus melanocephalus; larus michahellis; larus mongolicus; larus novaehollandiae; larus ridibundus; larus schistisagus; leiothrix argentauris; leiothrix lutea; lonchura striata; lophura leucomelanos; melanitta fusca; meleagris gallopavo; melospiza melodia; mergellus albellus; milvus migrans; mus musculus; mustela lutreola; mustela putorius; mustela putorius furo; myrmecophaga tridactyla; necrosyrtes monachus; neofelis nebulosa; neovison vison; netta peposaca; nisaetus nipalensis; numida meleagris; ondatra zibethicus; onychoprion fuscatus; oporornis tolmiei; panthera tigris; passer domesticus; passer montanus; passerella iliaca; pelecanus erythrorhynchos; phalacrocorax auritus; phalacrocorax carbo; phoca vitulina; piaya minuta; pica pica; pionus menstruus; piranga ludoviciana; pluvialis fulva; podiceps cristatus; puffinus pacificus; regulus satrapa; rissa tridactyla; seiurus noveboracensis; somateria mollissima; sterna hirundo; struthio camelus; sturnus sericeus; sturnus vulgaris; sus scrofa; sus scrofa domesticus; tachybaptus ruficollis; tadorna ferruginea; tadorna tadornoides; thryomanes bewickii; turdus migratorius; uria aalge; uria lomvia; zosterops japonicus
influenza b virus	Virus	3	canis lupus familiaris; felis catus; homo sapiens
influenza c virus	Virus	3	canis lupus; canis lupus familiaris; homo sapiens
inonotus tropicalis	Fungi	1	homo sapiens
janibacter anophelis	Bacteria	1	homo sapiens
japanese encephalitis virus	Virus	32	anopheles sinensis; armigeres subalbatus; bos taurus; canis lupus familiaris; capra hircus; columba livia; culex annulirostris; culex bitaeniorhynchus; culex gelidus; culex modestus; culex pipiens; culex pseudovishnui; culex quinquefasciatus; culex theileri; culex tritaeniorhynchus; culex vishnui; culex whitmorei; equus caballus; felis catus; forcipomyia taiwana; homo sapiens; miniopterus schreibersii; murina aurata; ovis aries; rhinolophus affinis; rousettus leschenaultii; scotophilus kuhlii; sturnus vulgaris; sus scrofa; sus scrofa domesticus; sus scrofa leucomystax; turdus merula
jc polyomavirus	Virus	1	homo sapiens
johnsonella ignava	Bacteria	1	homo sapiens
jonquetella anthropi	Bacteria	1	homo sapiens
junin virus	Virus	4	calomys laucha; calomys musculinus; homo sapiens; oligoryzomys flavescens
juquitiba virus	Virus	3	homo sapiens; oligoryzomys fornesi; oligoryzomys nigripes
kemerovo virus	Virus	4	homo sapiens; ixodes pavlovskyi; ixodes persulcatus; ixodes ricinus
kingella denitrificans	Bacteria	1	homo sapiens
kingella kingae	Bacteria	1	homo sapiens
kingella oralis	Bacteria	1	homo sapiens
klebsiella granulomatis	Bacteria	1	homo sapiens
klebsiella oxytoca	Bacteria	19	anopheles gambiae; arion lusitanicus; bactrocera tau; bos taurus; canis lupus; canis lupus familiaris; carica papaya; culex quinquefasciatus; cymbopogon citratus; helicoverpa armigera; homo sapiens; lantana camara; musa acuminata; orthosiphon stamineus; ovis aries; polyalthia longifolia; rattus norvegicus; saccharum officinarum; vitis vinifera
klebsiella pneumoniae	Bacteria	26	amphiprion nigripes; apis mellifera; bactrocera zonata; bos taurus; canis lupus; canis lupus familiaris; citrus maxima; culex quinquefasciatus; elaeis guineensis; equus caballus; gallus gallus; homo sapiens; musa acuminata; musca domestica; nezara viridula; oreochromis niloticus; oryctes rhinoceros; oryza sativa; piper nigrum; saccharum officinarum; steinernema thermophilum; sus scrofa; urochloa mutica; vigna radiata; zea mays; zingiber officinale
kluyvera ascorbata	Bacteria	2	homo sapiens; nepenthes albomarginata
kluyvera cryocrescens	Bacteria	5	arion lusitanicus; elymus tsukushiensis; epinephelus awoara; homo sapiens; solenopsis invicta
kluyveromyces marxianus	Fungi	1	homo sapiens
kocuria polaris	Bacteria	1	homo sapiens
kyasanur forest disease virus	Virus	3	homo sapiens; hyalomma dromedarii; ornithodoros savignyi
kytococcus schroeteri	Bacteria	2	culex quinquefasciatus; homo sapiens
kytococcus sedentarius	Bacteria	2	agelas oroides; homo sapiens
lacazia loboi	Fungi	1	homo sapiens
lactobacillus acidipiscis	Bacteria	1	homo sapiens
lactobacillus acidophilus	Bacteria	2	homo sapiens; sus scrofa
lactobacillus brevis	Bacteria	4	bos taurus; homo sapiens; punica granatum; zea mays
lactobacillus casei	Bacteria	2	bos taurus; homo sapiens
lactobacillus catenaformis	Bacteria	1	homo sapiens
lactobacillus coleohominis	Bacteria	1	homo sapiens
lactobacillus crispatus	Bacteria	2	gallus gallus; homo sapiens
lactobacillus delbrueckii	Bacteria	2	brassica rapa; homo sapiens
lactobacillus fermentum	Bacteria	5	apis dorsata; gallus gallus; homo sapiens; sus scrofa; zea mays
lactobacillus gasseri	Bacteria	2	homo sapiens; sialia sialis
lactobacillus gastricus	Bacteria	1	homo sapiens
lactobacillus helveticus	Bacteria	1	homo sapiens
lactobacillus iners	Bacteria	1	homo sapiens
lactobacillus jensenii	Bacteria	1	homo sapiens
lactobacillus johnsonii	Bacteria	5	apis mellifera; gallus gallus; homo sapiens; rattus norvegicus; sus scrofa
lactobacillus kalixensis	Bacteria	1	homo sapiens
lactobacillus mucosae	Bacteria	4	bos taurus; equus caballus; homo sapiens; sus scrofa
lactobacillus oris	Bacteria	1	homo sapiens
lactobacillus parabuchneri	Bacteria	1	homo sapiens
lactobacillus paracasei	Bacteria	1	homo sapiens
lactobacillus plantarum	Bacteria	10	apis dorsata; beta vulgaris; bos taurus; cucumis sativus; gallus gallus; homo sapiens; oncorhynchus mykiss; pandanus amaryllifolius; sus scrofa; zea mays
lactobacillus reuteri	Bacteria	8	canis lupus; canis lupus familiaris; gallus gallus; homo sapiens; meleagris gallopavo; mus musculus; rattus norvegicus; sus scrofa
lactobacillus rhamnosus	Bacteria	2	homo sapiens; zea mays
lactobacillus ruminis	Bacteria	4	bos taurus; equus caballus; homo sapiens; sus scrofa
lactobacillus sakei	Bacteria	3	bos taurus; branta canadensis; homo sapiens
lactobacillus salivarius	Bacteria	5	apis mellifera; bos taurus; gallus gallus; homo sapiens; sus scrofa
lactobacillus ultunensis	Bacteria	1	homo sapiens
lactobacillus vaginalis	Bacteria	1	homo sapiens
lactococcus garvieae	Bacteria	12	acipenser persicus; aplodactylus punctatus; bos taurus; citrus reticulata; homo sapiens; mugil cephalus; musca domestica; oncorhynchus mykiss; pelodiscus sinensis; seriola quinqueradiata; solenopsis invicta; thorectes lusitanicus
lactococcus lactis	Bacteria	27	anas platyrhynchos; bos taurus; capra hircus; culex quinquefasciatus; cyprinus carpio; daucus carota; epinephelus coioides; escherichia coli; etroplus maculatus; helix pomatia; hofmannophila pseudospretella; homo sapiens; odontesthes platensis; oncorhynchus mykiss; punica granatum; rana catesbeiana; raphanus sativus; reticulitermes chinensis; salmo trutta; spinacia oleracea; tabernaemontana divaricata; takifugu niphobles; vigna mungo; vigna radiata; vigna unguiculata; zea mays; zootermopsis angusticollis
lagochilascaris minor	Helminth	2	felis catus; homo sapiens
laguna negra virus	Virus	3	akodon simulator; calomys laucha; homo sapiens
lake victoria marburgvirus	Virus	4	hipposideros caffer; homo sapiens; mus musculus; rousettus aegyptiacus
laribacter hongkongensis	Bacteria	1	homo sapiens
lasiodiplodia theobromae	Fungi	77	acacia karroo; acacia mangium; acacia synchronicia; actinidia deliciosa; adansonia digitata; adansonia gregorii; adansonia za; anacardium excelsum; annona muricata; aquilaria crassna; aquilaria sinensis; araucaria cunninghamii; araucaria heterophylla; artocarpus altilis; artocarpus heterophyllus; azadirachta indica; camellia oleifera; carica papaya; casuarina cunninghamiana; cephalotaxus hainanensis; cocos nucifera; corymbia flavescens; crotalaria medicaginea; dimocarpus longan; diospyros kaki; eclipta prostrata; eucalyptus grandis; eucalyptus pellita; eucalyptus urophylla; ficus opposita; ficus trigona; grevillea robusta; hirtella americana; homo sapiens; jatropha curcas; khaya anthotheca; khaya ivorensis; lagenaria siceraria; lysiphyllum cunninghamii; malus x domestica; mangifera indica; manihot esculenta; melia azedarach; musa acuminata; musa x paradisiaca; nephelium lappaceum; nothapodytes nimmoniana; pachira macrocarpa; paullinia cupana; persea americana; pholidota pallida; pinus caribaea; pinus elliottii; pinus patula; piper hispidum; piper nigrum; pistacia vera; prunus armeniaca; pseudophoenix sargentii; pterocarpus angolensis; pyrus communis; santalum album; saraca asoca; schizolobium amazonicum; senna siamea; solanum melongena; sophora japonica; syzygium cordatum; syzygium samarangense; terminalia catappa; terminalia ivorensis; terminalia mantaly; theobroma cacao; vitex negundo; vitis quinquangularis; vitis vinifera; zea mays
lassa virus	Virus	2	homo sapiens; mastomys natalensis
lautropia mirabilis	Bacteria	1	homo sapiens
lebombo virus	Virus	1	homo sapiens
lechiguanas virus	Virus	2	homo sapiens; oligoryzomys flavescens
leclercia adecarboxylata	Bacteria	4	homo sapiens; leptinotarsa decemlineata; musca domestica; nepenthes mirabilis
lecythophora hoffmannii	Fungi	3	canis lupus; canis lupus familiaris; homo sapiens
lecythophora lignicola	Fungi	1	homo sapiens
lecythophora mutabilis	Fungi	1	homo sapiens
legionella anisa	Bacteria	1	homo sapiens
legionella longbeachae	Bacteria	1	homo sapiens
legionella pneumophila	Bacteria	2	acanthamoeba castellanii; homo sapiens
leishmania aethiopica	Protozoa	1	homo sapiens
leishmania amazonensis	Protozoa	1	homo sapiens
leishmania braziliensis	Protozoa	6	aotus azarai; canis lupus familiaris; equus caballus; felis catus; homo sapiens; rattus rattus
leishmania chagasi	Protozoa	5	canis lupus; canis lupus familiaris; dusicyon thous; homo sapiens; lutzomyia longipalpis
leishmania donovani	Protozoa	8	canis lupus; canis lupus familiaris; homo sapiens; mesocricetus auratus; phlebotomus argentipes; phlebotomus chinensis; rattus rattus; sergentomyia minuta
leishmania guyanensis	Protozoa	1	homo sapiens
leishmania infantum	Protozoa	12	canis lupus; canis lupus familiaris; cerdocyon thous; homo sapiens; lutzomyia longipalpis; mesocricetus auratus; phlebotomus ariasi; phlebotomus papatasi; phlebotomus perfiliewi; phlebotomus tobbi; rattus rattus; vulpes vulpes
leishmania lainsoni	Protozoa	1	homo sapiens
leishmania major	Protozoa	5	homo sapiens; mesocricetus auratus; phlebotomus papatasi; rattus rattus; rhombomys opimus
leishmania mexicana	Protozoa	4	canis lupus familiaris; felis catus; homo sapiens; lutzomyia ayacuchensis
leishmania panamensis	Protozoa	1	homo sapiens
leishmania peruviana	Protozoa	3	homo sapiens; lutzomyia peruensis; lutzomyia verrucarum
leishmania tropica	Protozoa	8	canis lupus; canis lupus familiaris; homo sapiens; phlebotomus duboscqi; phlebotomus papatasi; phlebotomus sergenti; procavia capensis; rhombomys opimus
leptosphaeria tompkinsii	Fungi	1	homo sapiens
leptospira borgpetersenii	Bacteria	9	bos taurus; desmodus rotundus; homo sapiens; mus musculus; ovis aries; rattus norvegicus; rattus rattus; sturnira lilium; sturnira tildae
leptospira inadai	Bacteria	1	homo sapiens
leptospira interrogans	Bacteria	27	apodemus flavicollis; bos taurus; canis latrans; canis lupus; canis lupus familiaris; capra hircus; cebus albifrons; cebus capucinus; cervus elaphus; equus caballus; felis catus; glossophaga soricina; homo sapiens; microtus socialis; mus musculus; myocastor coypus; ondatra zibethicus; ovis aries; promops centralis; rattus norvegicus; rattus rattus; rhinophylla pumilio; sus scrofa; sus scrofa domesticus; uroderma bilobatum; vulpes vulpes; zalophus californianus
leptospira kirschneri	Bacteria	5	apodemus agrarius; apodemus flavicollis; bos taurus; homo sapiens; phyllostomus hastatus
leptospira licerasiae	Bacteria	4	homo sapiens; philander opossum; rattus norvegicus; rattus rattus
leptospira noguchii	Bacteria	3	canis lupus familiaris; didelphis marsupialis; homo sapiens
leptospira santarosai	Bacteria	5	bos primigenius; canis lupus familiaris; capra hircus; homo sapiens; sus scrofa domesticus
leptospira weilii	Bacteria	2	equus caballus; homo sapiens
leptospira wolffii	Bacteria	4	canis lupus; canis lupus familiaris; homo sapiens; ovis aries
leptotrichia buccalis	Bacteria	1	homo sapiens
leptotrichia goodfellowii	Bacteria	1	homo sapiens
leptotrichia hofstadii	Bacteria	1	homo sapiens
leptotrichia shahii	Bacteria	1	homo sapiens
leptotrichia trevisanii	Bacteria	1	homo sapiens
leptotrichia wadei	Bacteria	1	homo sapiens
leuconostoc citreum	Bacteria	2	cytisus striatus; homo sapiens
leuconostoc fallax	Bacteria	1	homo sapiens
leuconostoc pseudomesenteroides	Bacteria	4	amorphophallus konjac; cucumis sativus; homo sapiens; prunus armeniaca
lewia infectoria	Fungi	2	diabrotica virgifera; homo sapiens
lichtheimia corymbifera	Fungi	2	bos taurus; homo sapiens
lichtheimia ramosa	Fungi	3	bos taurus; cavia porcellus; homo sapiens
listeria innocua	Bacteria	1	homo sapiens
listeria ivanovii	Bacteria	3	bos taurus; homo sapiens; ovis aries
listeria monocytogenes	Bacteria	18	apodemus agrarius; apodemus peninsulae; bos taurus; capra hircus; cavia porcellus; cervus elaphus; chinchilla brevicaudata; homo sapiens; lama pacos; microtus arvalis; myodes glareolus; myodes rufocanus; myodes rutilus; oryctolagus cuniculus; ovis aries; rattus rattus; sus scrofa; vulpes lagopus
listeria seeligeri	Bacteria	3	homo sapiens; ovis aries; sus scrofa
listeria welshimeri	Bacteria	1	homo sapiens
loa loa	Helminth	2	homo sapiens; mandrillus sphinx
lodderomyces elongisporus	Fungi	2	homo sapiens; xylosandrus mutilatus
louping ill virus	Virus	4	capra hircus; homo sapiens; ixodes persulcatus; ovis aries
lymphocytic choriomeningitis virus	Virus	7	apodemus sylvaticus; callimico goeldii; callithrix pygmaea; cavia porcellus; homo sapiens; mesocricetus auratus; mus musculus
lysinibacillus sphaericus	Bacteria	19	alligator sinensis; anopheles maculipennis; anopheles stephensi; arachis hypogaea; bistorta vivipara; cinnamomum pauciflorum; citrus limon; culex pipiens; homo sapiens; murraya koenigii; musa acuminata; nepenthes mirabilis; oryctolagus cuniculus; oryza sativa; panax ginseng; phaseolus vulgaris; poekilocerus pictus; theobroma cacao; zea mays
macacine herpesvirus 1	Virus	5	homo sapiens; macaca fascicularis; macaca fuscata; macaca mulatta; pan troglodytes
machupo virus	Virus	3	apodemus agrarius; calomys callosus; homo sapiens
macracanthorhynchus hirudinaceus	Helminth	3	homo sapiens; sus scrofa; sus scrofa domesticus
madrid virus	Virus	1	homo sapiens
madurella grisea	Fungi	1	homo sapiens
madurella mycetomatis	Fungi	1	homo sapiens
malassezia furfur	Fungi	3	canis lupus; canis lupus familiaris; homo sapiens
malassezia globosa	Fungi	1	homo sapiens
malassezia japonica	Fungi	1	homo sapiens
malassezia obtusa	Fungi	1	homo sapiens
malassezia pachydermatis	Fungi	5	bos taurus; canis lupus familiaris; felis catus; homo sapiens; sus scrofa
malassezia restricta	Fungi	1	homo sapiens
malassezia slooffiae	Fungi	3	capra hircus; felis catus; homo sapiens
malassezia sympodialis	Fungi	9	bos taurus; canis lupus; canis lupus familiaris; capra hircus; equus caballus; felis catus; homo sapiens; ovis aries; sus scrofa
malikia granosa	Bacteria	1	homo sapiens
mammalian orthoreovirus	Virus	11	bos taurus; canis lupus; canis lupus familiaris; homo sapiens; mus musculoides; paguma larvata; pipistrellus kuhlii; rhinolophus hipposideros; sus scrofa; tadarida teniotis; vespertilio murinus
mammomonogamus laryngeus	Helminth	2	bos taurus; homo sapiens
mannheimia haemolytica	Bacteria	6	bos taurus; capra hircus; homo sapiens; ovis aries; sus scrofa; sus scrofa domesticus
mansonella ozzardi	Helminth	1	homo sapiens
mansonella perstans	Helminth	1	homo sapiens
mansonella streptocerca	Helminth	1	homo sapiens
marburg marburgvirus	Virus	3	hipposideros caffer; homo sapiens; rousettus aegyptiacus
marituba virus	Virus	3	cebus apella; homo sapiens; nectomys squamipes
massilia timonae	Bacteria	3	brassica rapa; homo sapiens; zea mays
mayaro virus	Virus	1	homo sapiens
measles virus	Virus	2	homo sapiens; macaca mulatta
megasphaera elsdenii	Bacteria	2	homo sapiens; sus scrofa
megasphaera micronuciformis	Bacteria	1	homo sapiens
megasphaera sp.	Bacteria	1	homo sapiens
menangle virus	Virus	3	homo sapiens; sus scrofa; sus scrofa domesticus
mesocestoides lineatus	Helminth	6	canis lupus; canis lupus familiaris; felis catus; homo sapiens; vulpes corsac; vulpes vulpes
mesorhizobium loti	Bacteria	9	cicer arietinum; homo sapiens; lotus corniculatus; lotus cytisoides; lotus edulis; lotus japonicus; lotus ornithopodioides; oxytropis cachemiriana; robinia pseudoacacia
metagonimus yokogawai	Helminth	4	canis lupus familiaris; felis catus; homo sapiens; plecoglossus altivelis
methylobacterium radiotolerans	Bacteria	8	cytisus striatus; homo sapiens; melaleuca cajuputi; nicotiana tabacum; oryza sativa; passiflora edulis; saintpaulia ionantha; sarcodon aspratus
methylobacterium rhodesianum	Bacteria	1	homo sapiens
meyerozyma guilliermondii	Fungi	14	canis lupus; canis lupus familiaris; corydalus cornutus; dendroctonus adjunctus; dendroctonus approximatus; dendroctonus brevicomis; dendroctonus mexicanus; dendroctonus pseudotsugae; dendroctonus valens; helicoverpa armigera; homo sapiens; ips pini; ostrinia nubilalis; poekilocerus pictus
microbacterium aurum	Bacteria	2	brassica rapa; homo sapiens
microbacterium esteraromaticum	Bacteria	4	carica papaya; grateloupia lanceolata; homo sapiens; oreochromis niloticus
microbacterium flavescens	Bacteria	2	homo sapiens; robinia pseudoacacia
microbacterium foliorum	Bacteria	4	homo sapiens; oryza sativa; phaseolus vulgaris; solanum nigrum
microbacterium hydrocarbonoxydans	Bacteria	3	brassica rapa; homo sapiens; solanum nigrum
microbacterium lacticum	Bacteria	2	homo sapiens; saccharum officinarum
microbacterium oleivorans	Bacteria	3	homo sapiens; lolium perenne; phaseolus vulgaris
microbacterium oxydans	Bacteria	8	aplodactylus punctatus; arctium lappa; brassica rapa; bursaphelenchus mucronatus; chionoecetes japonicus; culex quinquefasciatus; homo sapiens; lolium perenne
microbacterium paraoxydans	Bacteria	6	anopheles stephensi; bemisia tabaci; citrullus lanatus; foeniculum vulgare; homo sapiens; oreochromis niloticus
microbacterium phyllosphaerae	Bacteria	6	homo sapiens; paeonia ostii; panax ginseng; phaseolus vulgaris; sphagnum magellanicum; ulva australis
microbacterium resistens	Bacteria	2	delonix regia; homo sapiens
microbacterium schleiferi	Bacteria	1	homo sapiens
microbacterium testaceum	Bacteria	3	homo sapiens; phaseolus vulgaris; suberites domuncula
microbacterium trichothecenolyticum	Bacteria	3	homo sapiens; lemna minor; robinia pseudoacacia
micrococcus luteus	Bacteria	18	acropora digitifera; anopheles gambiae; bemisia tabaci; capsicum annuum; chionoecetes japonicus; citrullus lanatus; dendroctonus rufipennis; dipturus batis; hebeloma crustuliniforme; homo sapiens; moschus berezovskii; musa acuminata; panax ginseng; phaseolus vulgaris; plectranthus barbatus; sphagnum magellanicum; ulva australis; vitis vinifera
microsporum audouinii	Fungi	1	homo sapiens
microsporum ferrugineum	Fungi	1	homo sapiens
microsporum gallinae	Fungi	2	gallus gallus; homo sapiens
microsporum gypseum	Fungi	5	canis lupus familiaris; equus caballus; homo sapiens; oryctolagus cuniculus; ovis aries
microsporum langeronii	Fungi	1	homo sapiens
microsporum persicolor	Fungi	1	homo sapiens
mobiluncus curtisii	Bacteria	1	homo sapiens
mogibacterium diversum	Bacteria	1	homo sapiens
mogibacterium neglectum	Bacteria	1	homo sapiens
mogibacterium pumilum	Bacteria	1	homo sapiens
mogibacterium timidum	Bacteria	1	homo sapiens
mogibacterium vescum	Bacteria	1	homo sapiens
mokola virus	Virus	3	canis lupus familiaris; felis catus; homo sapiens
molluscum contagiosum virus	Virus	2	equus asinus; homo sapiens
monkeypox virus	Virus	3	callithrix jacchus; homo sapiens; pan troglodytes
moraxella atlantae	Bacteria	1	homo sapiens
moraxella catarrhalis	Bacteria	1	homo sapiens
moraxella lacunata	Bacteria	1	homo sapiens
moraxella lincolnii	Bacteria	1	homo sapiens
moraxella nonliquefaciens	Bacteria	1	homo sapiens
moraxella osloensis	Bacteria	5	canis lupus; canis lupus familiaris; homo sapiens; pleurotus eryngii; sphagnum magellanicum
morganella morganii	Bacteria	7	bemisia tabaci; culex quinquefasciatus; glossina fuscipes; hirudo medicinalis; homo sapiens; musca domestica; oxytropis glabra
mouse mammary tumor virus	Virus	2	homo sapiens; mus musculus
mucor circinelloides	Fungi	2	homo sapiens; pelteobagrus fulvidraco
mucor hiemalis	Fungi	7	fragaria virginiana; holcus lanatus; homo sapiens; malus x domestica; oribatella quadricornuta; phalaris arundinacea; taxus baccata
mucor indicus	Fungi	2	fragaria x ananassa; homo sapiens
mucor ramosissimus	Fungi	1	homo sapiens
mumps virus	Virus	6	homo sapiens; papio anubis; papio cynocephalus; papio hamadryas; papio papio; papio ursinus
murine leukemia virus	Virus	13	bos taurus; halichoerus grypus; homo sapiens; meles meles; mus musculus; mus spretus; neovison vison; oryctolagus cuniculus; ovis aries; rattus norvegicus; sus scrofa; tadarida brasiliensis; vulpes vulpes
murray valley encephalitis virus	Virus	3	culex annulirostris; equus caballus; homo sapiens
myceliophthora thermophila	Fungi	1	homo sapiens
mycobacterium abscessus	Bacteria	1	homo sapiens
mycobacterium africanum	Bacteria	3	bos taurus; homo sapiens; sus scrofa
mycobacterium angelicum	Bacteria	2	homo sapiens; pterophyllum scalare
mycobacterium arupense	Bacteria	1	homo sapiens
mycobacterium austroafricanum	Bacteria	1	homo sapiens
mycobacterium avium	Bacteria	27	bison bison; bos indicus; bos taurus; canis lupus; canis lupus familiaris; capra hircus; capsicum annuum; cervus elaphus; escherichia coli; felis catus; gallus gallus; homo sapiens; lepus europaeus; lophophorus lhuysii; mus musculus; mycobacterium avium; netta rufina; oryctolagus cuniculus; ovis aries; poecile montanus; querula purpurata; sturnus vulgaris; sus scrofa; sus scrofa domesticus; syncerus caffer; tragopan caboti; vulpes vulpes
mycobacterium bacteremicum	Bacteria	1	homo sapiens
mycobacterium bohemicum	Bacteria	1	homo sapiens
mycobacterium bolletii	Bacteria	1	homo sapiens
mycobacterium bovis	Bacteria	17	bison bison; bos indicus; bos taurus; canis latrans; canis lupus familiaris; cervus elaphus; dama dama; felis catus; homo sapiens; meles meles; panthera leo; procyon lotor; rusa unicolor; sus scrofa; syncerus caffer; tragelaphus strepsiceros; vulpes vulpes
mycobacterium branderi	Bacteria	1	homo sapiens
mycobacterium canettii	Bacteria	1	homo sapiens
mycobacterium celatum	Bacteria	2	homo sapiens; mustela putorius
mycobacterium chelonae	Bacteria	6	bos taurus; carassius auratus; cyclopterus lumpus; danio rerio; homo sapiens; puntius conchonius
mycobacterium chimaera	Bacteria	1	homo sapiens
mycobacterium chlorophenolicum	Bacteria	1	homo sapiens
mycobacterium colombiense	Bacteria	1	homo sapiens
mycobacterium conceptionense	Bacteria	2	betta splendens; homo sapiens
mycobacterium conspicuum	Bacteria	1	homo sapiens
mycobacterium elephantis	Bacteria	1	homo sapiens
mycobacterium fortuitum	Bacteria	8	bos taurus; canis lupus familiaris; channa striata; felis catus; homo sapiens; oncorhynchus tshawytscha; poecilia reticulata; sus scrofa
mycobacterium gastri	Bacteria	1	homo sapiens
mycobacterium genavense	Bacteria	8	amazona farinosa; carduelis carduelis; carduelis chloris; carduelis cucullata; cyanoramphus novaezelandiae; homo sapiens; serinus canaria; taeniopygia guttata
mycobacterium goodii	Bacteria	1	homo sapiens
mycobacterium gordonae	Bacteria	3	corydoras sterbai; homo sapiens; morone saxatilis
mycobacterium haemophilum	Bacteria	2	danio rerio; homo sapiens
mycobacterium insubricum	Bacteria	1	homo sapiens
mycobacterium interjectum	Bacteria	1	homo sapiens
mycobacterium intracellulare	Bacteria	1	homo sapiens
mycobacterium kansasii	Bacteria	3	bos taurus; homo sapiens; sus scrofa
mycobacterium kumamotonense	Bacteria	1	homo sapiens
mycobacterium lentiflavum	Bacteria	1	homo sapiens
mycobacterium leprae	Bacteria	2	dasypus novemcinctus; homo sapiens
mycobacterium lepromatosis	Bacteria	1	homo sapiens
mycobacterium malmoense	Bacteria	1	homo sapiens
mycobacterium mantenii	Bacteria	1	homo sapiens
mycobacterium marinum	Bacteria	13	argyrosomus regius; chaetodon fasciatus; channa striata; cyprinus carpio; dicentrarchus labrax; diplodus puntazzo; homo sapiens; macropodus opercularis; melanotaenia praecox; morone saxatilis; pelodiscus sinensis; plecoglossus altivelis; siganus rivulatus
mycobacterium marseillense	Bacteria	1	homo sapiens
mycobacterium microti	Bacteria	1	homo sapiens
mycobacterium monacense	Bacteria	1	homo sapiens
mycobacterium mucogenicum	Bacteria	2	channa striata; homo sapiens
mycobacterium neoaurum	Bacteria	2	homo sapiens; paeonia ostii
mycobacterium noviomagense	Bacteria	1	homo sapiens
mycobacterium parascrofulaceum	Bacteria	1	homo sapiens
mycobacterium paraseoulense	Bacteria	1	homo sapiens
mycobacterium peregrinum	Bacteria	2	homo sapiens; tinca tinca
mycobacterium phlei	Bacteria	2	bos taurus; homo sapiens
mycobacterium porcinum	Bacteria	2	homo sapiens; sus scrofa
mycobacterium riyadhense	Bacteria	1	homo sapiens
mycobacterium scrofulaceum	Bacteria	3	bos taurus; homo sapiens; sus scrofa
mycobacterium senuense	Bacteria	1	homo sapiens
mycobacterium seoulense	Bacteria	1	homo sapiens
mycobacterium sherrisii	Bacteria	1	homo sapiens
mycobacterium shimoidei	Bacteria	1	homo sapiens
mycobacterium simiae	Bacteria	1	homo sapiens
mycobacterium smegmatis	Bacteria	6	bos taurus; canis lupus familiaris; felis catus; homo sapiens; sus scrofa; sus scrofa domesticus
mycobacterium szulgai	Bacteria	2	corydoras sterbai; homo sapiens
mycobacterium terrae	Bacteria	1	homo sapiens
mycobacterium thermoresistibile	Bacteria	1	homo sapiens
mycobacterium tilburgii	Bacteria	1	homo sapiens
mycobacterium tuberculosis	Bacteria	8	bos indicus; bos taurus; canis lupus familiaris; cervus elaphus; felis catus; homo sapiens; sus scrofa; sus scrofa domesticus
mycobacterium ulcerans	Bacteria	1	homo sapiens
mycobacterium vulneris	Bacteria	1	homo sapiens
mycobacterium xenopi	Bacteria	1	homo sapiens
mycoplasma arginini	Bacteria	5	bos taurus; capra hircus; homo sapiens; ovis aries; panthera leo
mycoplasma buccale	Bacteria	1	homo sapiens
mycoplasma faucium	Bacteria	1	homo sapiens
mycoplasma fermentans	Bacteria	1	homo sapiens
mycoplasma genitalium	Bacteria	1	homo sapiens
mycoplasma hominis	Bacteria	1	homo sapiens
mycoplasma ovis	Bacteria	4	capra hircus; capricornis crispus; homo sapiens; ovis aries
mycoplasma penetrans	Bacteria	1	homo sapiens
mycoplasma pneumoniae	Bacteria	1	homo sapiens
mycoplasma primatum	Bacteria	1	homo sapiens
mycoplasma salivarium	Bacteria	1	homo sapiens
myrmecridium schulzeri	Fungi	1	homo sapiens
naegleria fowleri	Protozoa	1	homo sapiens
naegleria philippinensis	Protozoa	1	homo sapiens
necator americanus	Helminth	5	canis lupus familiaris; felis catus; homo sapiens; mesocricetus auratus; sus scrofa
necropsobacter rosorum	Bacteria	3	cavia porcellus; homo sapiens; oryctolagus cuniculus
neisseria bacilliformis	Bacteria	1	homo sapiens
neisseria cinerea	Bacteria	1	homo sapiens
neisseria elongata	Bacteria	1	homo sapiens
neisseria flava	Bacteria	1	homo sapiens
neisseria flavescens	Bacteria	1	homo sapiens
neisseria gonorrhoeae	Bacteria	1	homo sapiens
neisseria lactamica	Bacteria	1	homo sapiens
neisseria macacae	Bacteria	1	homo sapiens
neisseria meningitidis	Bacteria	1	homo sapiens
neisseria mucosa	Bacteria	1	homo sapiens
neisseria pharyngis	Bacteria	1	homo sapiens
neisseria polysaccharea	Bacteria	1	homo sapiens
neisseria shayeganii	Bacteria	3	canis lupus; canis lupus familiaris; homo sapiens
neisseria sicca	Bacteria	1	homo sapiens
neisseria subflava	Bacteria	1	homo sapiens
neisseria weaveri	Bacteria	2	canis lupus familiaris; homo sapiens
neisseria zoodegmatis	Bacteria	1	homo sapiens
neocosmospora vasinfecta	Fungi	3	arachis hypogaea; glycine max; homo sapiens
neodeightonia subglobosa	Fungi	1	homo sapiens
neorickettsia sennetsu	Bacteria	3	canis lupus familiaris; equus caballus; homo sapiens
neosartorya hiratsukae	Fungi	1	homo sapiens
neoscytalidium dimidiatum	Fungi	1	homo sapiens
neurospora crassa	Fungi	1	homo sapiens
newcastle disease virus	Virus	48	accipiter gularis; aix galericulata; aix sponsa; anas acuta; anas carolinensis; anas clypeata; anas crecca; anas discors; anas formosa; anas fulvigula; anas penelope; anas platyrhynchos; anas rubripes; anser albifrons; anser fabalis; arenaria interpres; asio otus; aythya ferina; bonasa bonasia; branta canadensis; bubo virginianus; buteo lagopus; cairina moschata; calidris alba; calidris alpina; calidris canutus; calidris minutilla; columba livia; coturnix japonica; dendrocopos major; dromaius novaehollandiae; gallus gallus; haliaeetus leucocephalus; homo sapiens; inachis io; larus ridibundus; meleagris gallopavo; melopsittacus undulatus; pavo cristatus; phasianus colchicus; phoenicopterus ruber; rallus aquaticus; sternula albifrons; struthio camelus; sus scrofa; threskiornis aethiopicus; turdus merula; zenaida macroura
new york virus	Virus	2	homo sapiens; peromyscus leucopus
nipah virus	Virus	7	canis lupus familiaris; homo sapiens; pteropus giganteus; pteropus lylei; pteropus vampyrus; sus scrofa; sus scrofa domesticus
nocardia amamiensis	Bacteria	1	homo sapiens
nocardia asteroides	Bacteria	2	bos taurus; homo sapiens
nocardia beijingensis	Bacteria	1	homo sapiens
nocardia brasiliensis	Bacteria	2	felis catus; homo sapiens
nocardia cyriacigeorgica	Bacteria	1	homo sapiens
nocardia exalbida	Bacteria	1	homo sapiens
nocardia farcinica	Bacteria	2	bos taurus; homo sapiens
nocardia flavorosea	Bacteria	1	homo sapiens
nocardia nova	Bacteria	1	homo sapiens
nocardia otitidiscaviarum	Bacteria	1	homo sapiens
nocardiopsis dassonvillei	Bacteria	2	hibiscus syriacus; homo sapiens
norwalk virus	Virus	11	bos taurus; canis lupus; canis lupus familiaris; corbicula japonica; crassostrea rivularis; homo sapiens; mus musculus; ovis aries; panthera leo; sus scrofa; sus scrofa domesticus
novosphingobium aromaticivorans	Bacteria	1	homo sapiens
ochrobactrum anthropi	Bacteria	4	canis lupus; canis lupus familiaris; homo sapiens; pelodiscus sinensis
ochrobactrum haematophilum	Bacteria	2	arachis hypogaea; homo sapiens
ochrobactrum pseudintermedium	Bacteria	1	homo sapiens
ochrobactrum pseudogrignonense	Bacteria	4	allium sativum; aplysina lacunosa; homo sapiens; zingiber officinale
odoribacter splanchnicus	Bacteria	2	homo sapiens; sus scrofa
oesophagostomum bifurcum	Helminth	3	cercopithecus mona; homo sapiens; papio anubis
okadaella gastrococcus	Bacteria	1	homo sapiens
oligella urethralis	Bacteria	1	homo sapiens
olsenella profusa	Bacteria	1	homo sapiens
olsenella uli	Bacteria	1	homo sapiens
omsk hemorrhagic fever virus	Virus	4	androlaelaps casalis; dermacentor reticulatus; homo sapiens; ondatra zibethicus
onchocerca dewittei	Helminth	4	homo sapiens; simulium bidentatum; sus scrofa; sus scrofa leucomystax
onchocerca lupi	Helminth	4	canis lupus; canis lupus familiaris; felis catus; homo sapiens
onchocerca volvulus	Helminth	4	homo sapiens; simulium damnosum; simulium kilibanum; simulium neavei
ophiostoma stenoceras	Fungi	1	homo sapiens
opisthorchis felineus	Helminth	4	canis lupus familiaris; felis catus; homo sapiens; vulpes vulpes
opisthorchis viverrini	Helminth	4	bithynia funiculata; canis lupus familiaris; felis catus; homo sapiens
oran virus	Virus	2	homo sapiens; oligoryzomys longicaudatus
orf virus	Virus	8	budorcas taxicolor; camelus dromedarius; capra hircus; capricornis crispus; homo sapiens; ovibos moschatus; ovis aries; rangifer tarandus
oribacterium sinus	Bacteria	1	homo sapiens
oriboca virus	Virus	3	cebus apella; culex taeniopus; homo sapiens
orientia tsutsugamushi	Bacteria	13	apodemus agrarius; apodemus speciosus; bandicota indica; canis lupus; canis lupus familiaris; homo sapiens; leptotrombidium deliense; menetes berdmorei; mus musculus; ovis aries; rattus norvegicus; rattus rattus; tupaia glis
oropouche virus	Virus	3	bradypus tridactylus; culex quinquefasciatus; homo sapiens
orungo virus	Virus	1	homo sapiens
ostertagia ostertagi	Helminth	4	bos taurus; capra hircus; homo sapiens; ovis aries
paecilomyces lilacinus	Fungi	6	agrilus planipennis; graptopsaltria nigrofuscata; homo sapiens; meloidogyne enterolobii; phakellia fusca; philanthus triangulum
paecilomyces variotii	Fungi	8	grateloupia turuturu; grevillea robusta; homo sapiens; huperzia crispata; saraca asoca; theobroma cacao; volvariella volvacea; zea mays
paenibacillus alvei	Bacteria	4	citrus limon; homo sapiens; theobroma cacao; zea mays
paenibacillus barengoltzii	Bacteria	1	homo sapiens
paenibacillus pasadenensis	Bacteria	2	homo sapiens; vitis vinifera
pantoea agglomerans	Bacteria	62	abrus precatorius; aesculus hippocastanum; agave salmiana; aloe vera; anopheles stephensi; artocarpus integer; bactrocera tau; beta vulgaris; bos taurus; brassica napus; brassica oleracea; bursaphelenchus xylophilus; cajanus cajan; canis lupus; canis lupus familiaris; carica papaya; carludovica palmata; catharanthus roseus; ceiba pentandra; chionoecetes japonicus; cocos nucifera; cymbopogon citratus; daktulosphaira vitifoliae; daucus carota; elaeis guineensis; glycine max; gypsophila paniculata; hedysarum carnosum; homo sapiens; hylocereus undatus; ipomoea batatas; juglans regia; kandelia candel; lymantria dispar; mangifera indica; momordica charantia; morinda citrifolia; moringa oleifera; musa acuminata; myzus persicae; nepenthes mirabilis; nicotiana tabacum; oryza sativa; ovis aries; phaseolus vulgaris; pisum sativum; prunus dulcis; punica granatum; pyrus communis; ravenala madagascariensis; saccharum officinarum; solanum lycopersicum; sorghum bicolor; sphagnum fallax; suaeda salsa; sus scrofa; sus scrofa domesticus; tradescantia spathacea; triticum aestivum; vitis vinifera; zea mays; zingiber officinale
pantoea brenneri	Bacteria	1	homo sapiens
pantoea conspicua	Bacteria	2	homo sapiens; nicotiana tabacum
pantoea eucrina	Bacteria	3	homo sapiens; tradescantia spathacea; zea mays
pantoea septica	Bacteria	2	homo sapiens; populus euphratica
parabacteroides distasonis	Bacteria	1	homo sapiens
parabacteroides merdae	Bacteria	1	homo sapiens
paracoccidioides brasiliensis	Fungi	5	canis lupus; canis lupus familiaris; dasypus novemcinctus; homo sapiens; pygoscelis adeliae
paracoccus aminovorans	Bacteria	1	homo sapiens
paracoccus marcusii	Bacteria	1	homo sapiens
paracoccus marinus	Bacteria	1	homo sapiens
paracoccus solventivorans	Bacteria	1	homo sapiens
paracoccus yeei	Bacteria	2	capsicum annuum; homo sapiens
paracoccus zeaxanthinifaciens	Bacteria	1	homo sapiens
paragonimus africanus	Helminth	1	homo sapiens
paragonimus heterotremus	Helminth	4	canis lupus familiaris; felis catus; homo sapiens; indochinamon tannanti
paragonimus kellicotti	Helminth	5	canis lupus familiaris; felis catus; homo sapiens; indoplanorbis exustus; orconectes virilis
paragonimus miyazakii	Helminth	2	geothelphusa dehaani; homo sapiens
paragonimus skrjabini	Helminth	2	canis lupus familiaris; homo sapiens
paragonimus uterobilateralis	Helminth	1	homo sapiens
paragonimus westermani	Helminth	6	canis lupus; canis lupus familiaris; felis catus; homo sapiens; maydelliathelphusa lugubris; sus scrofa
parainfluenza virus 5	Virus	3	canis lupus; canis lupus familiaris; homo sapiens
paraprevotella clara	Bacteria	1	homo sapiens
paraprevotella xylaniphila	Bacteria	1	homo sapiens
parascardovia denticolens	Bacteria	1	homo sapiens
parascaris equorum	Helminth	3	equus burchellii; equus caballus; homo sapiens
parastrongylus cantonensis	Helminth	1	homo sapiens
parasutterella excrementihominis	Bacteria	1	homo sapiens
parvimonas micra	Bacteria	3	canis lupus; canis lupus familiaris; homo sapiens
pasteurella canis	Bacteria	5	canis lupus; canis lupus familiaris; erignathus barbatus; felis catus; homo sapiens
pasteurella dagmatis	Bacteria	5	canis lupus; canis lupus familiaris; felis catus; homo sapiens; panthera tigris
pasteurella multocida	Bacteria	26	anas platyrhynchos; bos grunniens; bos taurus; canis lupus familiaris; capra hircus; eptesicus serotinus; equus caballus; felis catus; gallus gallus; homo sapiens; meleagris gallopavo; melopsittacus undulatus; myotis mystacinus; oryctolagus cuniculus; ovis aries; ovis canadensis; pan troglodytes; pipistrellus kuhlii; pipistrellus nathusii; pipistrellus pipistrellus; pipistrellus pygmaeus; plecotus auritus; sus scrofa; sus scrofa domesticus; urochloa mutica; vespertilio murinus
pasteurella pneumotropica	Bacteria	8	canis lupus familiaris; curcuma longa; felis catus; homo sapiens; mus musculus; pandanus amaryllifolius; sansevieria trifasciata; sus scrofa
pasteurella stomatis	Bacteria	2	canis lupus familiaris; homo sapiens
pediculus humanus	Arthropod	1	homo sapiens
pediococcus acidilactici	Bacteria	3	bos taurus; homo sapiens; rattus norvegicus
pediococcus pentosaceus	Bacteria	6	acipenser persicus; bos taurus; cucumis sativus; gallus gallus; homo sapiens; punica granatum
penicillium biourgeianum	Fungi	2	homo sapiens; membranipora membranacea
penicillium brevicompactum	Fungi	1	homo sapiens
penicillium brocae	Fungi	1	homo sapiens
penicillium chrysogenum	Fungi	4	carcharodon carcharias; homo sapiens; ixodes scapularis; phakellia fusca
penicillium citreonigrum	Fungi	1	homo sapiens
penicillium citrinum	Fungi	24	acanthaster planci; acropora formosa; aquilaria crassna; arachis hypogaea; carapa guianensis; carcharodon carcharias; ceratonia siliqua; coffea arabica; cymodocea rotundata; enhalus acoroides; gorgonia ventalina; homo sapiens; huperzia crispata; hyoscyamus muticus; ipomoea batatas; ixeris repens; medicago sativa; nicotiana tabacum; ocimum tenuiflorum; paspalum wrightii; phalaris arundinacea; salicornia bigelovii; salicornia herbacea; vitis vinifera
penicillium decumbens	Fungi	4	devaleraea ramentacea; homo sapiens; mastocarpus stellatus; palmaria palmata
penicillium griseofulvum	Fungi	1	homo sapiens
penicillium marneffei	Fungi	1	homo sapiens
penicillium purpurogenum	Fungi	4	arachis hypogaea; cyperus esculentus; homo sapiens; phalaris arundinacea
penicillium raistrickii	Fungi	1	homo sapiens
penidiella venezuelensis	Fungi	1	homo sapiens
pentatrichomonas hominis	Protozoa	7	bos taurus; callithrix jacchus; canis lupus familiaris; colobus angolensis; felis catus; homo sapiens; varecia variegata
pepper mild mottle virus	Virus	3	capsicum annuum; capsicum frutescens; homo sapiens
peptoniphilus gorbachii	Bacteria	1	homo sapiens
peptoniphilus indolicus	Bacteria	2	bos taurus; homo sapiens
peptostreptococcus anaerobius	Bacteria	2	felis catus; homo sapiens
peptostreptococcus stomatis	Bacteria	1	homo sapiens
phaeoacremonium venezuelense	Fungi	1	homo sapiens
phaeomyces kuwaitiensis	Fungi	1	homo sapiens
phanerochaete sordida	Fungi	1	homo sapiens
phaneropsolus bonnei	Helminth	1	homo sapiens
phialemonium curvatum	Fungi	3	canis lupus; canis lupus familiaris; homo sapiens
phialemonium obovatum	Fungi	1	homo sapiens
phialophora verrucosa	Fungi	1	homo sapiens
photobacterium damselae	Bacteria	16	carcharhinus plumbeus; chromis punctipinnis; cynoglossus semilaevis; epinephelus lanceolatus; erythropodium caribaeorum; hippocampus ingens; homo sapiens; lates calcarifer; lutjanus guttatus; maja brachydactyla; scophthalmus maximus; seriola dumerili; seriola quinqueradiata; solea senegalensis; sparus aurata; uroteuthis chinensis
pichia kudriavzevii	Fungi	3	bos taurus; equus caballus; homo sapiens
pichia norvegensis	Fungi	1	homo sapiens
piedraia hortae	Fungi	1	homo sapiens
pigmentiphaga daeguensis	Bacteria	1	homo sapiens
plagiorchis muris	Helminth	1	homo sapiens
plasmodium falciparum	Protozoa	9	anopheles funestus; bos taurus; cercopithecus nictitans; gorilla beringei; gorilla gorilla; homo sapiens; mus musculus; pan paniscus; pan troglodytes
plasmodium knowlesi	Protozoa	4	homo sapiens; macaca fascicularis; macaca mulatta; macaca nemestrina
plasmodium malariae	Protozoa	3	homo sapiens; pan paniscus; pan troglodytes
plasmodium ovale	Protozoa	2	homo sapiens; pan troglodytes
plasmodium simium	Protozoa	2	homo sapiens; saimiri sciureus
plasmodium vivax	Protozoa	4	homo sapiens; pan troglodytes; pongo abelii; pongo pygmaeus
plesiomonas shigelloides	Bacteria	6	channa striata; homo sapiens; ictalurus punctatus; oreochromis niloticus; pelteobagrus fulvidraco; salmo trutta
pneumocystis carinii	Fungi	34	allenopithecus nigroviridis; apodemus sylvaticus; callimico goeldii; callithrix geoffroyi; callithrix jacchus; canis lupus; canis lupus familiaris; cercopithecus hamlyni; cercopithecus lhoesti; cercopithecus nictitans; eliomys quercinus; equus caballus; felis catus; gallus gallus; hapalemur griseus; homo sapiens; macaca fascicularis; macaca mulatta; macaca nemestrina; meriones unguiculatus; microcebus murinus; microtus agrestis; mus musculus; mustela putorius; mustela putorius furo; ovis aries; pithecia pithecia; rattus norvegicus; saguinus fuscicollis; saguinus imperator; saguinus midas; saguinus oedipus; saimiri sciureus; sorex araneus
pneumocystis jirovecii	Fungi	1	homo sapiens
porcine enterovirus b	Virus	3	homo sapiens; sus scrofa; sus scrofa domesticus
porcine type-c oncovirus	Virus	6	homo sapiens; phacochoerus africanus; sus barbatus; sus celebensis; sus scrofa; sus verrucosus
porphyromonas asaccharolytica	Bacteria	2	canis lupus familiaris; homo sapiens
porphyromonas catoniae	Bacteria	1	homo sapiens
porphyromonas endodontalis	Bacteria	1	homo sapiens
porphyromonas gingivalis	Bacteria	2	homo sapiens; ovis aries
porphyromonas uenonis	Bacteria	1	homo sapiens
powassan virus	Virus	5	dermacentor silvarum; haemaphysalis longicornis; homo sapiens; ixodes cookei; ixodes scapularis
prevotella amnii	Bacteria	1	homo sapiens
prevotella baroniae	Bacteria	1	homo sapiens
prevotella bergensis	Bacteria	1	homo sapiens
prevotella bivia	Bacteria	2	capra hircus; homo sapiens
prevotella buccae	Bacteria	1	homo sapiens
prevotella buccalis	Bacteria	2	capra hircus; homo sapiens
prevotella copri	Bacteria	1	homo sapiens
prevotella corporis	Bacteria	1	homo sapiens
prevotella dentalis	Bacteria	1	homo sapiens
prevotella denticola	Bacteria	1	homo sapiens
prevotella disiens	Bacteria	1	homo sapiens
prevotella intermedia	Bacteria	1	homo sapiens
prevotella loescheii	Bacteria	1	homo sapiens
prevotella maculosa	Bacteria	1	homo sapiens
prevotella marshii	Bacteria	1	homo sapiens
prevotella melaninogenica	Bacteria	1	homo sapiens
prevotella micans	Bacteria	1	homo sapiens
prevotella multiformis	Bacteria	1	homo sapiens
prevotella multisaccharivorax	Bacteria	1	homo sapiens
prevotella nanceiensis	Bacteria	1	homo sapiens
prevotella nigrescens	Bacteria	1	homo sapiens
prevotella oralis	Bacteria	1	homo sapiens
prevotella oris	Bacteria	1	homo sapiens
prevotella oulorum	Bacteria	1	homo sapiens
prevotella pallens	Bacteria	1	homo sapiens
prevotella ruminicola	Bacteria	2	homo sapiens; ovis aries
prevotella salivae	Bacteria	1	homo sapiens
prevotella stercorea	Bacteria	1	homo sapiens
prevotella tannerae	Bacteria	1	homo sapiens
prevotella veroralis	Bacteria	1	homo sapiens
primate t-lymphotropic virus 1	Virus	25	cercocebus agilis; cercocebus torquatus; cercopithecus ascanius; cercopithecus cephus; cercopithecus mitis; cercopithecus nictitans; cercopithecus pogonias; chlorocebus aethiops; homo sapiens; lophocebus albigena; macaca arctoides; macaca fascicularis; macaca maura; macaca mulatta; macaca nemestrina; mandrillus sphinx; pan troglodytes; papio anubis; papio cynocephalus; papio hamadryas; papio papio; piliocolobus badius; piliocolobus tephrosceles; symphalangus syndactylus; theropithecus gelada
primate t-lymphotropic virus 2	Virus	3	homo sapiens; pan paniscus; papio hamadryas
primate t-lymphotropic virus 3	Virus	15	cercocebus agilis; cercopithecus aethiops; cercopithecus cephus; cercopithecus mona; cercopithecus nictitans; homo sapiens; lophocebus albigena; mandrillus sphinx; pan troglodytes; papio anubis; papio cynocephalus; papio hamadryas; papio papio; papio ursinus; theropithecus gelada
propionibacterium acidifaciens	Bacteria	1	homo sapiens
propionibacterium acidipropionici	Bacteria	1	homo sapiens
propionibacterium acnes	Bacteria	8	bos taurus; canis lupus familiaris; eisenia fetida; equus caballus; homo sapiens; ovis aries; sus scrofa; sus scrofa domesticus
propionibacterium avidum	Bacteria	1	homo sapiens
propionibacterium granulosum	Bacteria	1	homo sapiens
propionibacterium propionicum	Bacteria	1	homo sapiens
prosthodendrium molenkampi	Helminth	1	homo sapiens
proteus mirabilis	Bacteria	19	alligator sinensis; apis mellifera; bombyx mori; bos taurus; canis lupus; canis lupus familiaris; equus caballus; felis catus; gallus gallus; homo sapiens; larus argentatus; mus musculus; musca domestica; ovis aries; rattus norvegicus; scylla paramamosain; solanum lycopersicum; sus scrofa; sus scrofa domesticus
proteus vulgaris	Bacteria	12	bos taurus; culex quinquefasciatus; felis catus; helicoverpa armigera; homo sapiens; ovis aries; phoenix canariensis; raphanus sativus; sardina pilchardus; silurus meridionalis; sus scrofa; triakis scyllium
prototheca wickerhamii	Fungi	1	homo sapiens
prototheca zopfii	Fungi	2	bos taurus; homo sapiens
providencia alcalifaciens	Bacteria	9	apis cerana; culex quinquefasciatus; drosophila melanogaster; epinephelus awoara; homo sapiens; musca domestica; plutella xylostella; sus scrofa domesticus; thorectes lusitanicus
providencia rettgeri	Bacteria	7	culex quinquefasciatus; galleria mellonella; homo sapiens; musca domestica; populus euphratica; sus scrofa; vitis vinifera
providencia stuartii	Bacteria	4	homo sapiens; leptonycteris curasoae; musca domestica; wohlfahrtia magnifica
pseudallescheria angusta	Fungi	1	homo sapiens
pseudallescheria boydii	Fungi	6	bos taurus; canis lupus familiaris; equus caballus; homo sapiens; phascolarctos cinereus; sus scrofa
pseudallescheria ellipsoidea	Fungi	1	homo sapiens
pseudallescheria minutispora	Fungi	1	homo sapiens
pseudocowpox virus	Virus	4	bos taurus; camelus dromedarius; homo sapiens; rangifer tarandus
pseudomonas aeruginosa	Bacteria	77	acipenser sturio; aloe vera; arachis hypogaea; bemisia tabaci; bos taurus; brassica rapa; canis lupus familiaris; capra hircus; capsicum annuum; capsicum frutescens; carica papaya; chamaesyce hirta; chromolaena odorata; cicer arietinum; citrullus lanatus; conus leopardus; conus litteratus; culex quinquefasciatus; curcuma longa; cyprinus carpio; diabrotica virgifera; equus caballus; etroplus maculatus; etroplus suratensis; euonymus japonicus; eutrema wasabi; gallus gallus; glomus mosseae; glycine max; gossypium hirsutum; helicoverpa armigera; homo sapiens; hyriopsis cumingii; labeo rohita; larimichthys crocea; leptinotarsa decemlineata; ligustrum sinense; luffa aegyptiaca; malus x domestica; mangifera indica; mimosa pudica; moschus berezovskii; musa acuminata; musca domestica; nicotiana glauca; nicotiana tabacum; oncorhynchus mykiss; oryctes rhinoceros; oryctolagus cuniculus; oryza sativa; ostrinia nubilalis; ovis aries; panax ginseng; parthenium hysterophorus; phaseolus vulgaris; pheretima sieboldi; phlebotomus papatasi; piper nigrum; pisum sativum; poekilocerus pictus; praecitrullus fistulosus; rhynchophorus ferrugineus; sesamum indicum; siganus canaliculatus; solanum lycopersicum; solanum melongena; solanum tuberosum; solenopsis invicta; spodoptera litura; suaeda maritima; sus scrofa; sus scrofa domesticus; triticum aestivum; vicia faba; yunnanacris yunnaneus; zea mays; zingiber officinale
pseudomonas alcaligenes	Bacteria	5	avenella flexuosa; capsicum annuum; homo sapiens; oreochromis niloticus; taxus globosa
pseudomonas anguilliseptica	Bacteria	3	anopheles stephensi; homo sapiens; oreochromis niloticus
pseudomonas fluorescens	Bacteria	50	abelmoschus esculentus; agaricus bisporus; andrias davidianus; anopheles stephensi; arachis hypogaea; bazzania trilobata; beta vulgaris; bombyx mori; brassica napus; brassica oleracea; brassica rapa; bursaphelenchus mucronatus; bursaphelenchus xylophilus; buxbaumia aphylla; cajanus cajan; capsicum annuum; cichorium endivia; cichorium intybus; corallorhiza trifida; cucumis sativus; euproctis chrysorhoea; gossypium hirsutum; homo sapiens; hygrophorus russula; laccaria bicolor; laccaria laccata; lactuca sativa; lemna minor; lentinula edodes; lupinus albus; macrotyloma uniflorum; melilotus indicus; microcystis aeruginosa; mucuna pruriens; nicotiana attenuata; nicotiana tabacum; oryza sativa; pisum sativum; pleurotus ostreatus; pyrus communis; sialia sialis; solanum lycopersicum; solanum tuberosum; sphagnum fallax; sphagnum palustre; thanatephorus cucumeris; triticum aestivum; vigna mungo; xiphias gladius; zea mays
pseudomonas meridiana	Bacteria	2	anopheles stephensi; homo sapiens
pseudomonas monteilii	Bacteria	7	azadirachta indica; chionoecetes opilio; cicer arietinum; homo sapiens; oreochromis niloticus; plectranthus barbatus; zea mays
pseudomonas mosselii	Bacteria	5	bruguiera gymnorhiza; homo sapiens; musa acuminata; oreochromis niloticus; oryza sativa
pseudomonas oryzihabitans	Bacteria	4	bemisia tabaci; homo sapiens; solanum nigrum; suaeda salsa
pseudomonas otitidis	Bacteria	3	aloe vera; anopheles stephensi; homo sapiens
pseudomonas pseudoalcaligenes	Bacteria	3	homo sapiens; musca domestica; rammeacris kiangsu
pseudomonas putida	Bacteria	45	acanthodiaptomus denticornis; allium sativum; arachis hypogaea; avena sativa; bactrocera tau; bemisia tabaci; beta vulgaris; cajanus cajan; carica papaya; chionoecetes opilio; cichorium endivia; cydonia oblonga; elaeis guineensis; glomus intraradices; homo sapiens; hymeniacidon perlevis; larimichthys crocea; lolium perenne; lymantria dispar; mammillaria fraileana; nicotiana attenuata; olea europaea; oryza sativa; padina pavonica; paeonia ostii; pangasianodon hypophthalmus; pinus tabuliformis; piper nigrum; pisum sativum; pleurotus ostreatus; portulaca grandiflora; prosopis strombulifera; saccharum officinarum; solanum lycopersicum; solanum tuberosum; sonchus arvensis; sorghum bicolor; suaeda salsa; thanatephorus cucumeris; thorectes lusitanicus; triticum aestivum; ulva rigida; vitis vinifera; zea mays; zosterops lateralis
pseudomonas stutzeri	Bacteria	31	anthyllis vulneraria; bemisia tabaci; chlorophytum borivilianum; cicer arietinum; costelytra zealandica; crassostrea virginica; culex quinquefasciatus; curcuma longa; echinacea tennesseensis; gracilaria corticata; helicoverpa armigera; homo sapiens; hordeum vulgare; hymeniacidon perlevis; hypnea musciformis; larimichthys crocea; musa acuminata; oryza sativa; plutella xylostella; populus euphratica; sarcocornia perennis; solanum melongena; sorghum bicolor; stellera chamaejasme; styela clava; thorectes lusitanicus; tillandsia recurvata; triticum aestivum; triticum turgidum; ulva reticulata; zea mays
pseudomonas synxantha	Bacteria	4	brassica rapa; homo sapiens; pisum sativum; pleurotus ostreatus
pseudoramibacter alactolyticus	Bacteria	1	homo sapiens
pseudoterranova decipiens	Helminth	11	chaenocephalus aceratus; cystophora cristata; enhydra lutris; eumetopias jubatus; halichoerus grypus; homo sapiens; lophius americanus; mirounga angustirostris; osmerus eperlanus; phoca vitulina; zalophus californianus
psychrobacter cibarius	Bacteria	1	homo sapiens
psychrobacter faecalis	Bacteria	1	homo sapiens
psychrobacter nivimaris	Bacteria	3	chionoecetes japonicus; homo sapiens; undaria pinnatifida
psychrobacter pulmonis	Bacteria	4	homo sapiens; ovis aries; populus euphratica; undaria pinnatifida
psychrobacter sanguinis	Bacteria	1	homo sapiens
pthirus pubis	Arthropod	1	homo sapiens
pulex irritans	Arthropod	4	canis lupus; canis lupus familiaris; felis catus; homo sapiens
puumala virus	Virus	7	apodemus agrarius; eothenomys regulus; homo sapiens; meriones tamariscinus; myodes glareolus; myodes regulus; myodes rufocanus
pygidiopsis summa	Helminth	1	homo sapiens
pyramidobacter piscolens	Bacteria	1	homo sapiens
pyrenochaeta mackinnonii	Fungi	2	guazuma ulmifolia; homo sapiens
pyrenochaeta romeroi	Fungi	4	annona squamosa; homo sapiens; hordeum vulgare; mangifera indica
pyrenochaeta unguis-hominis	Fungi	1	homo sapiens
pythium aphanidermatum	Fungi	1	homo sapiens
pythium insidiosum	Fungi	7	bos taurus; canis lupus; canis lupus familiaris; equus caballus; felis catus; homo sapiens; tremarctos ornatus
rabies virus	Virus	119	antrozous pallidus; artibeus fimbriatus; artibeus jamaicensis; artibeus lituratus; artibeus planirostris; atilax paludinosus; bassariscus astutus; bos primigenius; bos taurus; bubalus bubalis; callithrix jacchus; camelus bactrianus; camelus dromedarius; canis latrans; canis lupus; canis lupus familiaris; canis mesomelas; canis simensis; capra hircus; cebus apella; cervus nippon; chrysocyon brachyurus; civettictis civetta; connochaetes taurinus; corynorhinus townsendii; crocuta crocuta; cynictis penicillata; cynomops abrasus; desmodus rotundus; diphylla ecaudata; dusicyon thous; eptesicus brasiliensis; eptesicus diminutus; eptesicus furinalis; eptesicus fuscus; eptesicus serotinus; equus asinus; equus caballus; euderma maculatum; eumops auripendulus; eumops bonariensis; eumops glaucinus; eumops perotis; felis catus; felis nigripes; felis silvestris; galerella pulverulenta; galerella sanguinea; genetta genetta; glossophaga soricina; histiotus macrotus; homo sapiens; ichneumia albicauda; lama glama; lasionycteris noctivagans; lasiurus blossevillii; lasiurus borealis; lasiurus cinereus; lasiurus ega; lasiurus intermedius; lasiurus seminolus; lasiurus xanthinus; lycalopex vetulus; lynx lynx; lynx rufus; marmota monax; meles meles; melogale moschata; mephitis macroura; mephitis mephitis; molossops neglectus; molossus molossus; molossus rufus; mus musculus; mustela putorius; mustela putorius furo; myotis albescens; myotis austroriparius; myotis californicus; myotis chiloensis; myotis daubentonii; myotis evotis; myotis keenii; myotis levis; myotis lucifugus; myotis nigricans; myotis riparius; myotis thysanodes; myotis velifer; myotis yumanensis; nyctereutes procyonoides; nycticeius humeralis; nyctinomops laticaudatus; nyctinomops macrotis; otocolobus manul; otocyon megalotis; ovis aries; panthera pardus; paradoxurus zeylonensis; parastrellus hesperus; pecari tajacu; pipistrellus subflavus; plecotus auritus; potos flavus; procyon lotor; proteles cristatus; rangifer tarandus; spermophilus undulatus; suricata suricatta; sus scrofa; sus scrofa domesticus; tadarida brasiliensis; tragelaphus oryx; urocyon cinereoargenteus; ursus maritimus; vulpes chama; vulpes corsac; vulpes lagopus; vulpes vulpes
ralstonia pickettii	Bacteria	9	bemisia tabaci; capsicum frutescens; homo sapiens; pandora neoaphidis; populus euphratica; pristiphora abietina; rattus flavipectus; solanum lycopersicum; urochloa mutica
rhinocladiella aquaspersa	Fungi	1	homo sapiens
rhinocladiella basitona	Fungi	1	homo sapiens
rhinocladiella mackenziei	Fungi	1	homo sapiens
rhinosporidium seeberi	Fungi	1	homo sapiens
rhipicephalus bursa	Arthropod	1	homo sapiens
rhipicephalus sanguineus	Arthropod	8	bos taurus; canis lupus; canis lupus familiaris; capra hircus; homo sapiens; mustela putorius; ovis aries; vulpes vulpes
rhipicephalus turanicus	Arthropod	4	capra hircus; equus caballus; homo sapiens; ovis aries
rhizobium cellulosilyticum	Bacteria	3	homo sapiens; medicago lupulina; oxytropis cachemiriana
rhizomucor pusillus	Fungi	4	bos taurus; channa punctata; homo sapiens; phakellia fusca
rhizomucor tauricus	Fungi	1	homo sapiens
rhizopus microsporus	Fungi	2	homo sapiens; sus scrofa
rhizopus oryzae	Fungi	18	allium cepa; aloe vera; bos taurus; ciconia ciconia; codonopsis lanceolata; cotesia vestalis; homo sapiens; ipomoea batatas; jatropha curcas; lagenaria siceraria; ocimum basilicum; phoenix dactylifera; prunus armeniaca; sus scrofa; sus scrofa domesticus; theobroma cacao; tursiops truncatus; zea mays
rhizopus stolonifer	Fungi	3	homo sapiens; ipomoea batatas; zea mays
rhodobacter capsulatus	Bacteria	1	homo sapiens
rhodococcus equi	Bacteria	13	bos taurus; canis lupus familiaris; capreolus capreolus; cervus elaphus; elymus tsukushiensis; equus caballus; felis catus; haliclona simulans; homo sapiens; ovis aries; sus scrofa; sus scrofa domesticus; zea mays
rhodococcus rhodochrous	Bacteria	1	homo sapiens
rhodotorula minuta	Fungi	1	homo sapiens
rhodotorula mucilaginosa	Fungi	16	acianthera hamosa; aquilaria sinensis; berkheya coddii; dactylis glomerata; digitalis lanata; drosera rotundifolia; electra pilosa; ficus benjamina; ficus elastica; ficus religiosa; homo sapiens; malus x domestica; populus trichocarpa x populus deltoides; rumex hastatus; sphagnum girgensohnii; vitis vinifera
rickettsia africae	Bacteria	11	amblyomma variegatum; haemaphysalis longicornis; homo sapiens; hyalomma aegyptium; hyalomma detritum; hyalomma dromedarii; hyalomma impeltatum; ixodes granulatus; rhipicephalus decoloratus; rhipicephalus sanguineus; rhipicephalus turanicus
rickettsia akari	Bacteria	3	homo sapiens; liponyssoides sanguineus; mus musculus
rickettsia australis	Bacteria	1	homo sapiens
rickettsia conorii	Bacteria	6	amblyomma hebraeum; canis lupus; canis lupus familiaris; homo sapiens; rhipicephalus pumilio; rhipicephalus sanguineus
rickettsia felis	Bacteria	14	aedes albopictus; amblyomma americanum; apodemus agrarius; apodemus flavicollis; canis lupus familiaris; carios capensis; ctenocephalides canis; ctenocephalides felis; eulaelaps stabularis; felis catus; homo sapiens; liposcelis bostrychophila; myodes glareolus; rhipicephalus sanguineus
rickettsia japonica	Bacteria	1	homo sapiens
rickettsia massiliae	Bacteria	7	haemaphysalis longicornis; homo sapiens; rhipicephalus bursa; rhipicephalus pusillus; rhipicephalus sanguineus; rhipicephalus senegalensis; rhipicephalus turanicus
rickettsia monacensis	Bacteria	4	dermacentor marginatus; homo sapiens; ixodes persulcatus; ixodes ricinus
rickettsia prowazekii	Bacteria	5	bos taurus; felis catus; homo sapiens; pediculus humanus; sus scrofa
rickettsia rickettsii	Bacteria	18	amblyomma americanum; amblyomma cajennense; amblyomma imitator; bos taurus; canis lupus; canis lupus familiaris; ctenocephalides felis; dermacentor andersoni; dermacentor nitens; dermacentor occidentalis; dermacentor variabilis; equus caballus; felis catus; haemaphysalis leporispalustris; homo sapiens; ovis aries; rhipicephalus sanguineus; sus scrofa
rickettsia sibirica	Bacteria	3	homo sapiens; hyalomma truncatum; myodes rutilus
rickettsia slovaca	Bacteria	3	capra hircus; dermacentor marginatus; homo sapiens
rickettsia typhi	Bacteria	9	apodemus agrarius; canis lupus familiaris; felis catus; homo sapiens; mus musculus; pulex irritans; rattus norvegicus; rattus rattus; xenopsylla cheopis
rickettsiella melolonthae	Bacteria	1	homo sapiens
rift valley fever virus	Virus	23	aedes circumluteolus; aedes cumminsii; aedes mcintoshi; aedes ochraceus; aedes vexans; anopheles coustani; anopheles squamosus; bos taurus; capra hircus; culex antennatus; culex pipiens; culex poicilipes; culex zombaensis; eretmapodites quinquevittatus; hipposideros caffer; homo sapiens; mansonia africana; mansonia uniformis; micropteropus pusillus; ochlerotatus taeniorhynchus; ovis aries; rattus rattus; syncerus caffer
rio mamore virus	Virus	4	holochilus sciureus; homo sapiens; oligoryzomys fornesi; oligoryzomys microtis
roseburia faecis	Bacteria	1	homo sapiens
roseburia hominis	Bacteria	1	homo sapiens
roseburia intestinalis	Bacteria	1	homo sapiens
roseburia inulinivorans	Bacteria	1	homo sapiens
ross river virus	Virus	6	equus caballus; grallina cyanoleuca; homo sapiens; macropus agilis; microeca fascinans; poephila personata
rotavirus a	Virus	28	ailuropoda melanoleuca; bos taurus; bubalus bubalis; camelus bactrianus; camelus dromedarius; canis lupus; canis lupus familiaris; capra hircus; chlorocebus aethiops; equus caballus; felis catus; gallus gallus; giraffa camelopardalis; hippotragus niger; homo sapiens; lama guanicoe; macaca mulatta; macaca nemestrina; meleagris gallopavo; mus musculus; oryctolagus cuniculus; ovis aries; petaurus breviceps; sciurus vulgaris; sus scrofa; sus scrofa domesticus; tamiasciurus hudsonicus; vicugna vicugna
rotavirus b	Virus	5	bos taurus; homo sapiens; ovis aries; rattus rattus; sus scrofa
rotavirus c	Virus	5	bos taurus; homo sapiens; mustela putorius furo; sus scrofa; sus scrofa domesticus
rothia aeria	Bacteria	1	homo sapiens
rothia dentocariosa	Bacteria	1	homo sapiens
rothia mucilaginosa	Bacteria	3	canis lupus; canis lupus familiaris; homo sapiens
rubella virus	Virus	1	homo sapiens
rubrobacter xylanophilus	Bacteria	1	homo sapiens
ruminococcus gnavus	Bacteria	1	homo sapiens
saccharomyces boulardii	Fungi	1	homo sapiens
saccharomyces cerevisiae	Fungi	10	bos taurus; gallus gallus; homo sapiens; macrobrachium rosenbergii; mesocricetus auratus; mus musculus; polistes dominulus; rattus norvegicus; sus scrofa; vespa crabro
saccharopolyspora rectivirgula	Bacteria	2	bos taurus; homo sapiens
saimiriine herpesvirus 1	Virus	1	homo sapiens
saksenaea erythrospora	Fungi	1	homo sapiens
saksenaea vasiformis	Fungi	1	homo sapiens
salmonella enterica	Bacteria	20	bos taurus; brassica rapa; canis lupus; canis lupus familiaris; capra hircus; cynoscion nebulosus; equus caballus; gallus gallus; homo sapiens; lactuca sativa; mus musculus; oryctolagus cuniculus; ovis aries; perca fluviatilis; phocoena phocoena; piper nigrum; pistacia vera; scomberomorus cavalla; sus scrofa; sus scrofa domesticus
sandfly fever naples virus	Virus	7	homo sapiens; lemniscomys striatus; phlebotomus longicuspis; phlebotomus papatasi; phlebotomus perfiliewi; phlebotomus perniciosus; sergentomyia minuta
sandfly fever sicilian virus	Virus	6	homo sapiens; phlebotomus ariasi; phlebotomus longicuspis; phlebotomus papatasi; phlebotomus perniciosus; sergentomyia minuta
sanguibacter keddieii	Bacteria	1	homo sapiens
sapporo virus	Virus	3	homo sapiens; sus scrofa; sus scrofa domesticus
sarcinomyces phaeomuriformis	Fungi	1	homo sapiens
sarcocystis hominis	Protozoa	3	bos taurus; bubalus bubalis; homo sapiens
sarcocystis suihominis	Protozoa	2	homo sapiens; sus scrofa
sarcophaga caerulescens	Arthropod	1	homo sapiens
sarcoptes scabiei	Arthropod	15	capra ibex; capra pyrenaica; capricornis crispus; cervus elaphus; gazella subgutturosa; homo sapiens; martes foina; nyctereutes procyonoides; oryctolagus cuniculus; ovis aries; rupicapra pyrenaica; rupicapra rupicapra; sus scrofa; vombatus ursinus; vulpes vulpes
scardovia inopinata	Bacteria	1	homo sapiens
scardovia wiggsiae	Bacteria	1	homo sapiens
scedosporium apiospermum	Fungi	2	homo sapiens; trichechus manatus
scedosporium aurantiacum	Fungi	1	homo sapiens
scedosporium dehoogii	Fungi	1	homo sapiens
scedosporium prolificans	Fungi	1	homo sapiens
schistosoma bovis	Helminth	5	bos indicus; bos taurus; bulinus truncatus; homo sapiens; ovis aries
schistosoma haematobium	Helminth	7	bulinus forskalii; bulinus globosus; bulinus nyassanus; bulinus truncatus; cercopithecus aethiops; homo sapiens; papio anubis
schistosoma intercalatum	Helminth	1	homo sapiens
schistosoma japonicum	Helminth	11	bos taurus; canis lupus familiaris; capra hircus; equus caballus; felis catus; homo sapiens; microtus fortis; oncomelania hupensis; ovis aries; sus scrofa; sus scrofa domesticus
schistosoma malayensis	Helminth	1	homo sapiens
schistosoma mansoni	Helminth	17	arvicanthis niloticus; biomphalaria alexandrina; biomphalaria choanomphala; biomphalaria glabrata; biomphalaria pfeifferi; biomphalaria sudanica; biomphalaria tenagophila; bos taurus; canis lupus familiaris; felis catus; homo sapiens; meriones unguiculatus; mesocricetus auratus; mus musculus; pan troglodytes; rattus norvegicus; rattus rattus
schistosoma mattheei	Helminth	8	bos taurus; homo sapiens; ovis aries; papio anubis; papio cynocephalus; papio hamadryas; papio papio; papio ursinus
schistosoma mekongi	Helminth	2	homo sapiens; neotricula aperta
schistosoma spindale	Helminth	3	bos indicus; bos taurus; homo sapiens
schizophyllum commune	Fungi	1	homo sapiens
scolecobasidium humicola	Fungi	1	homo sapiens
scopulariopsis brevicaulis	Fungi	2	homo sapiens; phakellia fusca
scytalidium hyalinum	Fungi	1	homo sapiens
segniliparus rotundus	Bacteria	1	homo sapiens
selenomonas artemidis	Bacteria	1	homo sapiens
selenomonas dianae	Bacteria	1	homo sapiens
selenomonas flueggei	Bacteria	1	homo sapiens
selenomonas infelix	Bacteria	1	homo sapiens
selenomonas noxia	Bacteria	1	homo sapiens
selenomonas sputigena	Bacteria	1	homo sapiens
semliki forest virus	Virus	2	aedes ochraceus; homo sapiens
seoul virus	Virus	10	cricetulus barabensis; felis catus; homo sapiens; microtus fortis; mus musculus; rattus flavipectus; rattus norvegicus; rattus rattus; rattus tanezumi; tscherskia triton
serratia liquefaciens	Bacteria	4	dendroctonus valens; homo sapiens; manihot esculenta; sphagnum magellanicum
serratia marcescens	Bacteria	41	acropora palmata; amblyomma cajennense; amblyomma variegatum; anopheles stephensi; antheraea pernyi; apis cerana; apis mellifera; bombyx mori; bos taurus; brassica napus; bursaphelenchus xylophilus; canis lupus familiaris; capparis spinosa; capsicum annuum; citrullus lanatus; cucurbita pepo; culex quinquefasciatus; diabrotica virgifera; felis catus; glycine max; gossypium hirsutum; homo sapiens; kappaphycus alvarezii; labeo rohita; lemna minor; lymantria dispar; manduca sexta; musa acuminata; oryza sativa; paeonia anomala; piper nigrum; pisum sativum; porphyra yezoensis; prunus domestica; psoroptes ovis; solanum lycopersicum; solanum nigrum; solenopsis invicta; sophora alopecuroides; vitis vinifera; zingiber officinale
serratia proteamaculans	Bacteria	7	brassica napus; bursaphelenchus xylophilus; costelytra zealandica; dendroctonus valens; etroplus suratensis; homo sapiens; sphagnum magellanicum
setosphaeria rostrata	Fungi	1	homo sapiens
severe acute respiratory syndrome-related coronavirus	Virus	7	chlorocebus aethiops; homo sapiens; mus musculus; paguma larvata; rhinolophus ferrumequinum; rhinolophus macrotis; rhinolophus sinicus
shewanella algae	Bacteria	4	aplysina insularis; haliotis diversicolor; homo sapiens; sciaenops ocellatus
shigella boydii	Bacteria	2	gallus gallus; homo sapiens
shigella dysenteriae	Bacteria	1	homo sapiens
shigella flexneri	Bacteria	5	culex quinquefasciatus; gallus gallus; homo sapiens; musca domestica; vigna radiata
shigella sonnei	Bacteria	3	homo sapiens; musca domestica; porphyra yezoensis
shuttleworthia satelles	Bacteria	1	homo sapiens
simian foamy virus	Virus	50	allenopithecus nigroviridis; callithrix jacchus; cercocebus agilis; cercocebus torquatus; cercopithecus albogularis; cercopithecus cephus; cercopithecus hamlyni; cercopithecus lhoesti; cercopithecus mona; cercopithecus neglectus; chlorocebus aethiops; chlorocebus pygerythrus; chlorocebus sabaeus; colobus guereza; erythrocebus patas; gorilla gorilla; homo sapiens; hylobates pileatus; lophocebus albigena; lophocebus aterrimus; macaca arctoides; macaca balantak; macaca fascicularis; macaca fuscata; macaca maura; macaca mulatta; macaca nemestrina; macaca radiata; macaca silenus; macaca sylvanus; macaca thibetana; macaca tonkeana; mandrillus leucophaeus; mandrillus sphinx; miopithecus talapoin; nomascus leucogenys; pan paniscus; pan troglodytes; papio anubis; papio cynocephalus; papio hamadryas; papio papio; papio ursinus; piliocolobus badius; piliocolobus tephrosceles; pongo abelii; pongo pygmaeus; pygathrix nemaeus; theropithecus gelada; trachypithecus francoisi
simian virus 40	Virus	2	homo sapiens; macaca mulatta
simonsiella muelleri	Bacteria	1	homo sapiens
sindbis virus	Virus	9	aedes cinereus; anopheles maculipennis; culex annulirostris; culex bitaeniorhynchus; culex torrentium; culex tritaeniorhynchus; homo sapiens; motacilla alba; ornithonyssus bursa
sin nombre virus	Virus	6	homo sapiens; peromyscus californicus; peromyscus leucopus; peromyscus maniculatus; peromyscus truei; reithrodontomys megalotis
sinorhizobium medicae	Bacteria	17	homo sapiens; lotus corniculatus; macroptilium atropurpureum; medicago arabica; medicago ciliaris; medicago lupulina; medicago orbicularis; medicago polymorpha; medicago sativa; medicago sphaerocarpa; medicago truncatula; melilotus albus; melilotus indicus; melilotus officinalis; ornithopus perpusillus; prosopis alba; trifolium repens
slackia exigua	Bacteria	1	homo sapiens
sneathia sanguinegens	Bacteria	1	homo sapiens
solobacterium moorei	Bacteria	1	homo sapiens
sphingomonas koreensis	Bacteria	1	homo sapiens
sphingomonas melonis	Bacteria	2	apis cerana; homo sapiens
sphingomonas paucimobilis	Bacteria	3	amanita muscaria; anopheles stephensi; homo sapiens
sphingomonas rhizogenes	Bacteria	1	homo sapiens
spirillum minus	Bacteria	1	homo sapiens
spirocerca lupi	Helminth	3	canis lupus; canis lupus familiaris; homo sapiens
spirometra erinaceieuropaei	Helminth	7	canis lupus; canis lupus familiaris; elaphe quadrivirgata; felis catus; homo sapiens; litoria caerulea; rana nigromaculata
sporopachydermia lactativora	Fungi	1	homo sapiens
sporothrix albicans	Fungi	2	homo sapiens; zootermopsis nevadensis
sporothrix brasiliensis	Fungi	3	canis lupus; canis lupus familiaris; homo sapiens
sporothrix mexicana	Fungi	1	homo sapiens
sporothrix schenckii	Fungi	4	canis lupus; canis lupus familiaris; equus caballus; homo sapiens
staphylococcus aureus	Bacteria	21	achaea janata; anas platyrhynchos; bos taurus; camelus dromedarius; canis lupus; canis lupus familiaris; capsicum annuum; columba livia; eidolon helvum; equus caballus; felis catus; gallus gallus; gorilla gorilla; homo sapiens; meleagris gallopavo; oryctolagus cuniculus; ovis aries; rattus norvegicus; sus scrofa; taeniopygia guttata; vitis vinifera
staphylococcus capitis	Bacteria	4	bemisia tabaci; equus caballus; homo sapiens; moschus berezovskii
staphylococcus caprae	Bacteria	4	culex quinquefasciatus; homo sapiens; phaseolus vulgaris; sphagnum fallax
staphylococcus cohnii	Bacteria	6	culex quinquefasciatus; cytisus striatus; homo sapiens; lymantria dispar; rhodnius colombiensis; sardinella longiceps
staphylococcus epidermidis	Bacteria	25	asobara tabida; azadirachta indica; bemisia tabaci; bos taurus; brassica rapa; culex quinquefasciatus; cytisus striatus; eisenia fetida; equus caballus; glossina fuscipes; homo sapiens; maja brachydactyla; medicago truncatula; mus musculus; musa acuminata; nicotiana glauca; ovis aries; panax ginseng; phaseolus vulgaris; pleurotus eryngii; solenopsis invicta; sphagnum fallax; sphagnum magellanicum; sphagnum palustre; vitis vinifera
staphylococcus haemolyticus	Bacteria	12	bemisia tabaci; bos taurus; canis lupus; canis lupus familiaris; culex quinquefasciatus; equus caballus; homo sapiens; mus musculus; musa acuminata; nicotiana glauca; phaseolus vulgaris; urochloa mutica
staphylococcus hominis	Bacteria	12	acacia senegal; anopheles stephensi; bos taurus; canis lupus; canis lupus familiaris; culex quinquefasciatus; dendroctonus rufipennis; homo sapiens; mimulus aurantiacus; oryctolagus cuniculus; phaseolus vulgaris; solenopsis invicta
staphylococcus intermedius	Bacteria	7	canis lupus; canis lupus familiaris; equus caballus; felis catus; homo sapiens; sus scrofa; sus scrofa domesticus
staphylococcus lentus	Bacteria	5	canis lupus; canis lupus familiaris; homo sapiens; lymantria dispar; ovis aries
staphylococcus lugdunensis	Bacteria	2	bos taurus; homo sapiens
staphylococcus nepalensis	Bacteria	3	capra hircus; homo sapiens; sus scrofa
staphylococcus pasteuri	Bacteria	16	asobara tabida; bemisia tabaci; bos taurus; brassica rapa; costelytra zealandica; elaeis guineensis; homo sapiens; nicotiana glauca; nicotiana tabacum; panax ginseng; phaseolus vulgaris; populus euphratica; rattus norvegicus; sphagnum fallax; sphagnum magellanicum; vitis vinifera
staphylococcus pettenkoferi	Bacteria	2	brassica rapa; homo sapiens
staphylococcus pseudintermedius	Bacteria	3	canis lupus; canis lupus familiaris; homo sapiens
staphylococcus saprophyticus	Bacteria	16	anopheles stephensi; apis cerana; bemisia tabaci; bos taurus; culex quinquefasciatus; homo sapiens; lepidium didymum; lutjanus guttatus; lymantria dispar; musca domestica; myodes glareolus; phaseolus vulgaris; phoenix canariensis; populus euphratica; rhipicephalus microplus; sphaerophysa salsula
staphylococcus sciuri	Bacteria	12	amblyomma cajennense; bos taurus; canis lupus; canis lupus familiaris; culex quinquefasciatus; equus caballus; gallus gallus; harmonia axyridis; homo sapiens; mauremys mutica; nicotiana tabacum; solanum tuberosum
staphylococcus succinus	Bacteria	4	choristoneura fumiferana; culex quinquefasciatus; homo sapiens; riptortus clavatus
staphylococcus warneri	Bacteria	11	bos taurus; culex quinquefasciatus; gallus gallus; homo sapiens; medicago truncatula; musca domestica; nicotiana glauca; phaseolus vulgaris; prunus dulcis; sus scrofa; zea mays
stellantchasmus falcatus	Helminth	3	felis catus; homo sapiens; mus musculus
stenella araguata	Fungi	1	homo sapiens
stenotrophomonas maltophilia	Bacteria	56	acropora digitifera; amblyomma cajennense; ammophila arenaria; apis mellifera; avena sativa; axinella corrugata; azadirachta indica; bactrocera zonata; bemisia tabaci; bistorta vivipara; brassica napus; brassica oleracea; bursaphelenchus mucronatus; bursaphelenchus xylophilus; chionoecetes japonicus; chionoecetes opilio; citrus limon; clitoria ternatea; culex quinquefasciatus; cytisus striatus; dendroctonus rhizophagus; dendroctonus valens; echinacea angustifolia; gentiana macrophylla; glomus intraradices; glomus mosseae; hedera helix; helicoverpa armigera; hevea brasiliensis; homo sapiens; hyriopsis cumingii; ictalurus punctatus; leucojum aestivum; macrotermes michaelseni; mucuna pruriens; musca domestica; nicotiana glauca; panax ginseng; perinereis aibuhitensis; phaseolus vulgaris; phoenix dactylifera; pisum sativum; poekilocerus pictus; populus euphratica; prosopis juliflora; raphanus sativus; saccharum officinarum; sialia sialis; solanum virginianum; sus scrofa; taxus globosa; thanatephorus cucumeris; trichogramma chilonis; vigna mungo; zea mays; zingiber officinale
sterigmatomyces halophilus	Fungi	1	homo sapiens
stictodora fuscata	Helminth	1	homo sapiens
st. louis encephalitis virus	Virus	31	aedes aegypti; anopheles albitarsis; anopheles triannulatus; butorides virescens; calomys musculinus; cebus apella; colaptes auratus; conopophaga aurita; culex coronator; culex declarator; culex nigripalpus; culex pipiens; culex quinquefasciatus; culex tarsalis; didelphis marsupialis; gallus gallus; geotrygon montana; haemagogus equinus; homo sapiens; hypocnemis cantator; mus musculus; myiobius barbatus; myrmotherula hauxwelli; ochlerotatus scapularis; passer domesticus; procyon lotor; psorophora ferox; quiscalus quiscula; saltator maximus; willisornis poecilinotus; zenaida macroura
streptobacillus moniliformis	Bacteria	4	canis lupus familiaris; homo sapiens; rattus norvegicus; rattus rattus
streptococcus agalactiae	Bacteria	11	bos taurus; canis lupus; canis lupus familiaris; capra hircus; halichoerus grypus; homo sapiens; oncorhynchus mykiss; oreochromis niloticus; oryctolagus cuniculus; ovis aries; trachurus japonicus
streptococcus anginosus	Bacteria	1	homo sapiens
streptococcus australis	Bacteria	1	homo sapiens
streptococcus canis	Bacteria	5	bos taurus; canis lupus; canis lupus familiaris; felis catus; homo sapiens
streptococcus constellatus	Bacteria	1	homo sapiens
streptococcus cristatus	Bacteria	1	homo sapiens
streptococcus downei	Bacteria	1	homo sapiens
streptococcus dysgalactiae	Bacteria	16	ailuropoda melanoleuca; bos taurus; canis lupus; canis lupus familiaris; capra hircus; equus caballus; homo sapiens; lutjanus stellatus; oncorhynchus mykiss; oreochromis niloticus; ovis aries; paguma larvata; seriola dumerili; sus scrofa; sus scrofa domesticus; trachinotus blochii
streptococcus equi	Bacteria	9	bos taurus; canis lupus; canis lupus familiaris; capra hircus; equus caballus; homo sapiens; ovis aries; sus scrofa; sus scrofa domesticus
streptococcus equinus	Bacteria	4	bos taurus; camelus bactrianus; camelus dromedarius; homo sapiens
streptococcus gordonii	Bacteria	1	homo sapiens
streptococcus infantis	Bacteria	1	homo sapiens
streptococcus iniae	Bacteria	9	cyprinus carpio; homo sapiens; ictalurus punctatus; inia geoffrensis; oncorhynchus mykiss; oreochromis niloticus; paralichthys olivaceus; rana catesbeiana; selenotoca multifasciata
streptococcus intermedius	Bacteria	1	homo sapiens
streptococcus milleri	Bacteria	1	homo sapiens
streptococcus mitis	Bacteria	1	homo sapiens
streptococcus mutans	Bacteria	1	homo sapiens
streptococcus oralis	Bacteria	1	homo sapiens
streptococcus parasanguinis	Bacteria	1	homo sapiens
streptococcus pasteurianus	Bacteria	1	homo sapiens
streptococcus peroris	Bacteria	1	homo sapiens
streptococcus pneumoniae	Bacteria	6	bos taurus; canis lupus familiaris; capra hircus; equus caballus; homo sapiens; ovis aries
streptococcus pseudopneumoniae	Bacteria	1	homo sapiens
streptococcus pyogenes	Bacteria	6	bos taurus; canis lupus; canis lupus familiaris; equus caballus; homo sapiens; sus scrofa
streptococcus salivarius	Bacteria	3	brassica rapa; homo sapiens; sialia sialis
streptococcus sanguinis	Bacteria	1	homo sapiens
streptococcus sinensis	Bacteria	1	homo sapiens
streptococcus sobrinus	Bacteria	1	homo sapiens
streptococcus suis	Bacteria	6	bos taurus; felis catus; homo sapiens; ovis aries; sus scrofa; sus scrofa domesticus
streptococcus uberis	Bacteria	4	bos taurus; homo sapiens; oncorhynchus mykiss; ovis aries
streptococcus vestibularis	Bacteria	2	homo sapiens; sialia sialis
streptomyces somaliensis	Fungi	7	broussonetia papyrifera; eucommia ulmoides; homo sapiens; ligustrum sinense; morus alba; prunus sibirica; strophanthus divaricatus
strongyloides fuelleborni	Helminth	6	gorilla gorilla; homo sapiens; macaca fuscata; macaca mulatta; pan troglodytes; papio cynocephalus
strongyloides papillosus	Helminth	4	bos taurus; capra hircus; homo sapiens; ovis aries
strongyloides stercoralis	Helminth	5	canis lupus; canis lupus familiaris; felis catus; homo sapiens; pan troglodytes
sudan ebolavirus	Virus	1	homo sapiens
suid herpesvirus 1	Virus	9	bos taurus; canis lupus; canis lupus familiaris; felis catus; homo sapiens; ovis aries; procyon lotor; sus scrofa; sus scrofa domesticus
sutterella parvirubra	Bacteria	1	homo sapiens
sutterella sanguinus	Bacteria	1	homo sapiens
sutterella wadsworthensis	Bacteria	1	homo sapiens
swine vesicular disease virus	Virus	3	homo sapiens; sus scrofa; sus scrofa domesticus
taenia asiatica	Helminth	1	homo sapiens
taenia crassiceps	Helminth	10	canis lupus; canis lupus familiaris; homo sapiens; microtus fortis; microtus gregalis; microtus levis; microtus pennsylvanicus; mus musculus; vulpes lagopus; vulpes vulpes
taenia multiceps	Helminth	6	bos taurus; canis lupus; canis lupus familiaris; capra hircus; homo sapiens; ovis aries
taenia saginata	Helminth	2	bos taurus; homo sapiens
taenia serialis	Helminth	7	canis aureus; canis lupus; canis lupus familiaris; felis catus; homo sapiens; oryctolagus cuniculus; theropithecus gelada
taenia solium	Helminth	3	homo sapiens; sus scrofa; sus scrofa domesticus
taenia taeniaeformis	Helminth	13	apodemus sylvaticus; arvicola terrestris; canis lupus; canis lupus familiaris; falco tinnunculus; felis catus; homo sapiens; microtus arvalis; mus musculus; procyon lotor; rattus norvegicus; rattus rattus; vulpes vulpes
tai forest ebolavirus	Virus	1	homo sapiens
talaromyces eburneus	Fungi	1	homo sapiens
talaromyces indigoticus	Fungi	1	homo sapiens
tannerella forsythia	Bacteria	1	homo sapiens
tatlockia micdadei	Bacteria	1	homo sapiens
tatumella ptyseos	Bacteria	3	ananas comosus; homo sapiens; vitis vinifera
teladorsagia circumcincta	Helminth	4	capra hircus; homo sapiens; ovis aries; rangifer tarandus
ternidens deminutus	Helminth	4	cercopithecus mona; homo sapiens; macaca fascicularis; papio anubis
terrahaemophilus aromaticivorans	Bacteria	1	homo sapiens
thelazia callipaeda	Helminth	4	canis lupus; canis lupus familiaris; felis catus; homo sapiens
thermoascus crustaceus	Fungi	1	homo sapiens
thogoto virus	Virus	1	homo sapiens
tick-borne encephalitis virus	Virus	19	apodemus agrarius; apodemus speciosus; apodemus sylvaticus; capra hircus; cricetulus barabensis; haemaphysalis longicornis; homo sapiens; ixodes hexagonus; ixodes pavlovskyi; ixodes persulcatus; ixodes ricinus; macaca sylvanus; microtus gregalis; microtus oeconomus; mus musculus; myodes glareolus; myodes rufocanus; ovis aries; spermophilus undulatus
torque teno midi virus 1	Virus	1	homo sapiens
torque teno midi virus 2	Virus	1	homo sapiens
torque teno mini virus 1	Virus	1	homo sapiens
torque teno mini virus 5	Virus	1	homo sapiens
torque teno mini virus 6	Virus	1	homo sapiens
torque teno mini virus 8	Virus	1	homo sapiens
torque teno virus 10	Virus	1	homo sapiens
torque teno virus 9	Virus	1	homo sapiens
toxascaris leonina	Helminth	8	canis latrans; canis lupus; canis lupus familiaris; felis catus; homo sapiens; lynx lynx; puma concolor; vulpes vulpes
toxocara canis	Helminth	7	alopex lagopus; canis lupus; canis lupus familiaris; felis catus; homo sapiens; meriones unguiculatus; vulpes vulpes
toxocara cati	Helminth	2	felis catus; homo sapiens
toxoplasma gondii	Protozoa	38	apodemus sylvaticus; bison bison; bos taurus; camelus dromedarius; canis latrans; canis lupus; canis lupus familiaris; capra hircus; capreolus capreolus; cervus elaphus; columba livia; equus asinus; equus caballus; felis catus; felis silvestris; gallus gallus; homo sapiens; lama glama; lynx lynx; lynx rufus; mephitis mephitis; mus musculus; mustela vison; odocoileus virginianus; oryctolagus cuniculus; ovis aries; passer domesticus; phoca vitulina; procyon lotor; puma concolor; rangifer tarandus; rattus norvegicus; rattus rattus; sus scrofa; sus scrofa domesticus; urocyon cinereoargenteus; ursus americanus; vulpes vulpes
trachipleistophora hominis	Fungi	1	homo sapiens
treponema amylovorum	Bacteria	1	homo sapiens
treponema carateum	Bacteria	1	homo sapiens
treponema denticola	Bacteria	2	bos taurus; homo sapiens
treponema lecithinolyticum	Bacteria	1	homo sapiens
treponema maltophilum	Bacteria	1	homo sapiens
treponema medium	Bacteria	1	homo sapiens
treponema pallidum	Bacteria	6	homo sapiens; papio anubis; papio cynocephalus; papio hamadryas; papio papio; papio ursinus
treponema putidum	Bacteria	1	homo sapiens
treponema socranskii	Bacteria	1	homo sapiens
treponema vincentii	Bacteria	1	homo sapiens
trichinella britovi	Helminth	7	canis lupus; homo sapiens; lynx lynx; nyctereutes procyonoides; panthera pardus; sus scrofa; vulpes vulpes
trichinella nativa	Helminth	6	alopex lagopus; canis lupus familiaris; homo sapiens; nyctereutes procyonoides; ursus maritimus; vulpes vulpes
trichinella nelsoni	Helminth	1	homo sapiens
trichinella papuae	Helminth	3	crocodylus porosus; homo sapiens; sus scrofa
trichinella pseudospiralis	Helminth	3	homo sapiens; procyon lotor; sus scrofa
trichinella spiralis	Helminth	15	canis lupus familiaris; equus caballus; felis catus; homo sapiens; lynx rufus; meles meles; mephitis mephitis; mus musculus; nyctereutes procyonoides; procyon lotor; rattus norvegicus; sus scrofa; sus scrofa domesticus; ursus americanus; vulpes vulpes
trichobilharzia ocellata	Helminth	2	homo sapiens; lymnaea stagnalis
trichoderma longibrachiatum	Fungi	1	homo sapiens
trichomonas tenax	Protozoa	1	homo sapiens
trichomonas vaginalis	Protozoa	1	homo sapiens
trichophyton concentricum	Fungi	1	homo sapiens
trichophyton equinum	Fungi	2	equus caballus; homo sapiens
trichophyton megninii	Fungi	2	canis lupus familiaris; homo sapiens
trichophyton mentagrophytes	Fungi	10	bos taurus; canis lupus familiaris; cervus nippon; equus caballus; felis catus; homo sapiens; oryctolagus cuniculus; phodopus sungorus; sus scrofa; sus scrofa domesticus
trichophyton raubitschekii	Fungi	1	homo sapiens
trichophyton rubrum	Fungi	2	homo sapiens; sus scrofa
trichophyton schoenleinii	Fungi	1	homo sapiens
trichophyton soudanense	Fungi	1	homo sapiens
trichophyton tonsurans	Fungi	1	homo sapiens
trichophyton verrucosum	Fungi	8	bos taurus; canis lupus familiaris; capra hircus; equus caballus; felis catus; homo sapiens; ovis aries; sus scrofa
trichophyton violaceum	Fungi	1	homo sapiens
trichosporon asahii	Fungi	2	homo sapiens; phascolarctos cinereus
trichosporon asteroides	Fungi	1	homo sapiens
trichosporon beigelii	Fungi	1	homo sapiens
trichosporon coremiiforme	Fungi	1	homo sapiens
trichosporon cutaneum	Fungi	1	homo sapiens
trichosporon dermatis	Fungi	1	homo sapiens
trichosporon faecale	Fungi	2	homo sapiens; phascolarctos cinereus
trichosporon inkin	Fungi	1	homo sapiens
trichosporon mucoides	Fungi	2	homo sapiens; membranipora membranacea
trichostrongylus axei	Helminth	11	antilocapra americana; bison bison; bos taurus; capra hircus; cervus elaphus; equus caballus; homo sapiens; odocoileus hemionus; odocoileus virginianus; ovis aries; ovis canadensis
trichostrongylus colubriformis	Helminth	5	bos taurus; capra hircus; homo sapiens; meriones unguiculatus; ovis aries
trichostrongylus orientalis	Helminth	1	homo sapiens
trichuris suis	Helminth	4	homo sapiens; sus scrofa; sus scrofa domesticus; sus scrofa scrofa
trichuris trichiura	Helminth	7	canis lupus; canis lupus familiaris; colobus guereza; homo sapiens; macaca fuscata; nomascus gabriellae; papio ursinus
trichuris vulpis	Helminth	4	canis lupus; canis lupus familiaris; homo sapiens; vulpes vulpes
tritirachium oryzae	Fungi	1	homo sapiens
tritrichomonas foetus	Protozoa	5	bos taurus; felis catus; homo sapiens; sus scrofa; sus scrofa domesticus
tropheryma whipplei	Bacteria	1	homo sapiens
trypanosoma brucei	Protozoa	16	bos indicus; bos taurus; canis lupus familiaris; capra hircus; cercopithecus aethiops; equus caballus; felis catus; glossina morsitans; glossina pallidipes; glossina palpalis; homo sapiens; mus musculus; ovis aries; panthera leo; sus scrofa; sus scrofa domesticus
trypanosoma cruzi	Protozoa	69	artibeus planirostris; canis lupus; canis lupus familiaris; capra hircus; carollia perspicillata; cebus albifrons; cebus apella; chrotopterus auritus; dasyprocta fuliginosa; dasyprocta leporina; dasypus novemcinctus; didelphis albiventris; didelphis aurita; didelphis marsupialis; euphractus sexcinctus; euryoryzomys macconnelli; felis catus; gallus gallus; holochilus brasiliensis; homo sapiens; hylaeamys megacephalus; lophostoma silvicola; macaca mulatta; mepraia spinolai; mesocricetus auratus; monodelphis brevicaudata; mus musculus; myotis albescens; myotis levis; myotis nigricans; myotis ruber; nasua nasua; noctilio albiventris; octodon degus; oryctolagus cuniculus; panstrongylus geniculatus; panstrongylus megistus; philander frenatus; philander opossum; phyllostomus discolor; phyllostomus hastatus; procyon lotor; proechimys longicaudatus; rattus rattus; rhodnius brethesi; rhodnius colombiensis; rhodnius neglectus; rhodnius pallescens; rhodnius pictipes; rhodnius prolixus; rhodnius robustus; rhodnius stali; saguinus bicolor; saguinus fuscicollis; saguinus labiatus; saguinus midas; saimiri sciureus; saimiri ustus; sus scrofa; sus scrofa domesticus; thyroptera tricolor; tonatia bidens; triatoma dimidiata; triatoma infestans; triatoma nitida; triatoma protracta; triatoma rubrovaria; triatoma sanguisuga; trinomys iheringi
trypanosoma rangeli	Protozoa	12	artibeus planirostris; homo sapiens; panstrongylus megistus; phyllomys dasythrix; platyrrhinus lineatus; rhodnius pallescens; rhodnius pictipes; rhodnius prolixus; rhodnius robustus; saguinus bicolor; saimiri sciureus; tamandua tetradactyla
tsukamurella tyrosinosolvens	Bacteria	3	apis cerana; cytisus scoparius; homo sapiens
tunga penetrans	Arthropod	5	canis lupus; canis lupus familiaris; homo sapiens; myrmecophaga tridactyla; sus scrofa
turicibacter sanguinis	Bacteria	1	homo sapiens
uncinaria stenocephala	Helminth	7	canis lupus; canis lupus familiaris; felis catus; homo sapiens; urocyon littoralis; vulpes lagopus; vulpes vulpes
ureaplasma parvum	Bacteria	1	homo sapiens
ureaplasma urealyticum	Bacteria	1	homo sapiens
usutu virus	Virus	4	culex pipiens; homo sapiens; parus major; turdus merula
vaccinia virus	Virus	8	alouatta caraya; bos taurus; bubalus bubalis; cebus apella; equus caballus; homo sapiens; mus musculus; oryctolagus cuniculus
vagococcus fluvialis	Bacteria	2	culex quinquefasciatus; homo sapiens
varibaculum cambriense	Bacteria	1	homo sapiens
variola virus	Virus	1	homo sapiens
variovorax paradoxus	Bacteria	8	beta vulgaris; boehmeria nivea; brassica napus; homo sapiens; lemna minor; lolium perenne; paeonia ostii; pisum sativum
veillonella atypica	Bacteria	1	homo sapiens
veillonella dispar	Bacteria	1	homo sapiens
veillonella parvula	Bacteria	3	anas platyrhynchos; homo sapiens; sus scrofa
veillonella ratti	Bacteria	1	homo sapiens
venezuelan equine encephalitis virus	Virus	10	aedes aegypti; bos taurus; culex coronator; culex mollis; culex portesi; equus caballus; homo sapiens; ochlerotatus scapularis; sus scrofa; sus scrofa domesticus
verrallina lugubris	Arthropod	1	homo sapiens
verticillium leptobactrum	Fungi	2	heterodera glycines; homo sapiens
vesicular exanthema of swine virus	Virus	7	bos taurus; callorhinus ursinus; homo sapiens; mephitis mephitis; sus scrofa; sus scrofa domesticus; zalophus californianus
vibrio alginolyticus	Bacteria	15	aplysina lacunosa; crassostrea gigas; haliotis corrugata; hippocampus guttulatus; hippocampus ingens; homo sapiens; lateolabrax japonicus; maja brachydactyla; mussismilia hispida; palythoa caribaeorum; palythoa variabilis; penaeus monodon; scophthalmus maximus; sphoeroides annulatus; trachinotus blochii
vibrio cholerae	Bacteria	11	anas platyrhynchos; anopheles stephensi; aquilaria malaccensis; cyprinus carpio; homo sapiens; ictalurus punctatus; misgurnus anguillicaudatus; mytilus edulis; pampus argenteus; pelteobagrus fulvidraco; siniperca chuatsi
vibrio cincinnatiensis	Bacteria	1	homo sapiens
vibrio fluvialis	Bacteria	1	homo sapiens
vibrio furnissii	Bacteria	1	homo sapiens
vibrio mimicus	Bacteria	3	etroplus suratensis; homo sapiens; lutjanus guttatus
vibrio parahaemolyticus	Bacteria	18	apostichopus japonicus; argopecten purpuratus; caryota mitis; crassostrea corteziensis; epinephelus akaara; eriocheir sinensis; homo sapiens; kandelia candel; litopenaeus vannamei; meretrix meretrix; mytilus edulis; mytilus galloprovincialis; palythoa caribaeorum; penaeus monodon; portunus trituberculatus; pseudoplexaura porosa; pseudopterogorgia elisabethae; rachycentron canadum
vibrio vulnificus	Bacteria	4	homo sapiens; mytilus edulis; nibea albiflora; portunus trituberculatus
victivallis vadensis	Bacteria	1	homo sapiens
vittaforma corneae	Fungi	1	homo sapiens
weeksella virosa	Bacteria	1	homo sapiens
weissella cibaria	Bacteria	4	brassica oleracea; cucumis sativus; homo sapiens; zea mays
weissella confusa	Bacteria	1	homo sapiens
wesselsbron virus	Virus	9	aedes circumluteolus; aedes mcintoshi; bos taurus; capra hircus; desmodillus auricularis; equus caballus; homo sapiens; mansonia uniformis; ovis aries
western equine encephalomyelitis virus	Virus	7	culex tarsalis; equus caballus; gopherus berlandieri; homo sapiens; ochlerotatus dorsalis; sciurus griseus; zonotrichia leucophrys
west nile virus	Virus	82	accipiter cooperii; accipiter gentilis; aedes albopictus; aedes cinereus; aedes vexans; aegypius monachus; agelaius phoeniceus; anas querquedula; anopheles messeae; anopheles subpictus; anser anser; aquila chrysaetos; argynnis pandora; athene noctua; bonasa umbellus; branta canadensis; bubo virginianus; bubulcus ibis; buteo jamaicensis; buteo lineatus; butorides virescens; canis lupus; canis lupus familiaris; carios capensis; carpodacus mexicanus; colaptes auratus; columba livia; corvus brachyrhynchos; corvus corax; corvus cornix; corvus corone; corvus frugilegus; culex annulirostris; culex bitaeniorhynchus; culex interrogator; culex nigripalpus; culex pipiens; culex pseudovishnui; culex quinquefasciatus; culex restuans; culex salinarius; culex tarsalis; culex univittatus; culex vishnui; culex whitmorei; culiseta melanura; cyanocitta cristata; dermacentor marginatus; equus caballus; falco columbarius; falco punctatus; falco sparverius; gallus gallus; garrulus glandarius; homo sapiens; mephitis mephitis; mesocricetus auratus; mimus polyglottos; molothrus ater; mus musculus; ochlerotatus canadensis; ochlerotatus cantator; ochlerotatus sollicitans; ochlerotatus sticticus; ochlerotatus triseriatus; ochlerotatus trivittatus; ovis aries; passer domesticus; phalacrocorax carbo; pica pica; poecile atricapilla; psorophora ferox; quiscalus quiscula; rana ridibundus; rousettus leschenaultii; sciurus carolinensis; sciurus niger; sus scrofa; sus scrofa domesticus; turdus merula; turdus migratorius; zenaida macroura
wickerhamomyces anomalus	Fungi	5	anopheles stephensi; chrysoperla sillemi; chrysoperla zastrowi; homo sapiens; trichogramma chilonis
williamsia serinedens	Bacteria	1	homo sapiens
wohlfahrtia nuba	Arthropod	1	homo sapiens
wuchereria bancrofti	Helminth	2	homo sapiens; meriones unguiculatus
wyeomyia virus	Virus	1	homo sapiens
xanthomonas campestris	Bacteria	13	brassica napus; brassica oleracea; brassica rapa; capsicum annuum; homo sapiens; leersia hexandra; matthiola incana; musa acuminata; paeonia ostii; pilea glaberrima; raphanus sativus; syngonium podophyllum; zea mays
xenophilus aerolata	Bacteria	1	homo sapiens
yaba monkey tumor virus	Virus	1	homo sapiens
yarrowia lipolytica	Fungi	1	homo sapiens
yellow fever virus	Virus	12	aedes aegypti; aedes africanus; aedes furcifer; aedes luteocephalus; aedes taylori; aedes vittatus; alouatta caraya; alouatta seniculus; erythrocebus patas; homo sapiens; mesocricetus auratus; sabethes albiprivus
yersinia aleksiciae	Bacteria	2	homo sapiens; rattus rattus
yersinia enterocolitica	Bacteria	5	homo sapiens; pipistrellus pipistrellus; rattus norvegicus; sus scrofa; tscherskia triton
yersinia frederiksenii	Bacteria	3	aesculus hippocastanum; costelytra zealandica; homo sapiens
yersinia intermedia	Bacteria	2	homo sapiens; ictalurus punctatus
yersinia kristensenii	Bacteria	2	homo sapiens; sphagnum fallax
yersinia pestis	Bacteria	13	bolomys lasiurus; canis latrans; canis lupus familiaris; cerradomys subflavus; felis catus; homo sapiens; marmota baibacina; mus musculus; oropsylla hirsuta; rattus norvegicus; rattus rattus; rhombomys opimus; xenopsylla cheopis
yersinia pseudotuberculosis	Bacteria	9	bos taurus; canis lupus familiaris; capra hircus; felis catus; homo sapiens; myotis myotis; ovis aries; sus scrofa; sus scrofa domesticus
yersinia ruckeri	Bacteria	12	acipenser schrenckii; anguilla japonica; ctenopharyngodon idella; homo sapiens; hypophthalmichthys nobilis; ictalurus punctatus; megalobrama amblycephala; micropterus salmoides; oncorhynchus mykiss; pelteobagrus fulvidraco; salmo salar; salvelinus fontinalis
yokenella regensburgei	Bacteria	1	homo sapiens
zaire ebolavirus	Virus	5	cavia porcellus; gorilla beringei; gorilla gorilla; homo sapiens; pan troglodytes
zika virus	Virus	1	homo sapiens
