Species	Species.classification	N	Country
abiotrophia defectiva	Bacteria	1	united kingdom
acanthamoeba castellanii	Protozoa	3	united states; united kingdom; taiwan
acanthamoeba culbertsoni	Protozoa	1	united states
acanthamoeba lenticulata	Protozoa	3	south africa; taiwan; france
acanthamoeba polyphaga	Protozoa	5	germany; taiwan; united kingdom; japan; united states
achromobacter denitrificans	Bacteria	3	india; italy; china
achromobacter piechaudii	Bacteria	2	iran; china
achromobacter xylosoxidans	Bacteria	18	india; denmark; argentina; united kingdom; portugal; russia; hungary; iran; uruguay; italy; germany; japan; china; czech republic; thailand; united states; belgium; slovakia
acinetobacter baumannii	Bacteria	35	kenya; finland; iran; italy; sweden; chile; united states; south korea; haiti; greece; japan; china; france; colombia; poland; thailand; united kingdom; brazil; norway; malaysia; india; tunisia; iraq; ireland; turkey; singapore; australia; germany; argentina; lithuania; russia; canada; portugal; taiwan; hong kong
acinetobacter berezinae	Bacteria	1	portugal
acinetobacter calcoaceticus	Bacteria	12	finland; sweden; mali; china; slovakia; thailand; united kingdom; india; saudi arabia; kyrgyzstan; spain; malaysia
acinetobacter haemolyticus	Bacteria	2	india; brazil
acinetobacter johnsonii	Bacteria	9	china; germany; spain; india; brazil; japan; mexico; greece; malaysia
acinetobacter junii	Bacteria	9	china; argentina; taiwan; mexico; india; japan; ukraine; austria; brazil
acinetobacter lwoffii	Bacteria	14	israel; india; japan; netherlands; thailand; poland; china; mexico; france; spain; taiwan; russia; united kingdom; ukraine
acinetobacter parvus	Bacteria	2	canada; czech republic
acinetobacter radioresistens	Bacteria	5	france; india; iraq; malaysia; italy
acinetobacter ursingii	Bacteria	3	india; czech republic; canada
acremonium strictum	Fungi	10	australia; spain; mexico; united states; austria; china; india; brazil; belgium; sweden
actinobacillus pleuropneumoniae	Bacteria	6	japan; taiwan; denmark; switzerland; china; canada
actinobaculum schaalii	Bacteria	2	canada; netherlands
actinomadura madurae	Bacteria	1	china
actinomucor elegans	Fungi	4	china; czech republic; south africa; united states
actinomyces funkei	Bacteria	1	switzerland
actinomyces georgiae	Bacteria	1	switzerland
actinomyces graevenitzii	Bacteria	1	japan
actinomyces naeslundii	Bacteria	3	united kingdom; sweden; united states
actinomyces oricola	Bacteria	1	united kingdom
actinomyces oris	Bacteria	4	argentina; united states; sweden; united kingdom
adlercreutzia equolifaciens	Bacteria	1	japan
aedes aegypti	Arthropod	35	thailand; india; french southern territories; vietnam; gabon; argentina; united kingdom; mozambique; guadeloupe; cambodia; united states; brazil; french guiana; martinique; reunion; french polynesia; ivory coast; saudi arabia; guinea; madagascar; australia; tanzania; taiwan; china; cuba; malaysia; peru; singapore; mexico; myanmar; new caledonia; trinidad and tobago; panama; puerto rico; maldives
aerococcus viridans	Bacteria	6	hungary; india; iran; slovakia; united states; china
aeromonas aquariorum	Bacteria	5	australia; israel; portugal; south korea; china
aeromonas bestiarum	Bacteria	8	antarctica; switzerland; spain; france; united states; germany; australia; finland
aeromonas caviae	Bacteria	9	india; canada; portugal; brazil; japan; france; china; australia; taiwan
aeromonas enteropelogenes	Bacteria	2	portugal; india
aeromonas hydrophila	Bacteria	29	india; japan; portugal; thailand; australia; germany; greece; mexico; finland; colombia; bangladesh; china; norway; switzerland; spain; malaysia; united states; brazil; france; sweden; israel; singapore; united kingdom; iran; morocco; canada; russia; taiwan; egypt
aeromonas salmonicida	Bacteria	22	india; denmark; norway; australia; united kingdom; switzerland; greece; germany; ireland; portugal; south korea; spain; russia; united states; finland; israel; china; lithuania; japan; turkey; canada; chile
aeromonas sobria	Bacteria	6	india; japan; lithuania; china; hungary; spain
aeromonas tecta	Bacteria	3	malaysia; spain; switzerland
aeromonas veronii	Bacteria	19	india; japan; united kingdom; china; mexico; portugal; brazil; united states; iran; france; south korea; israel; australia; malaysia; spain; bangladesh; south africa; singapore; hungary
aggregatibacter actinomycetemcomitans	Bacteria	4	france; united states; ireland; japan
aggregatibacter aphrophilus	Bacteria	1	denmark
aggregatibacter segnis	Bacteria	2	denmark; sweden
agrobacterium larrymoorei	Bacteria	2	latvia; united states
agrobacterium rhizogenes	Bacteria	5	spain; japan; poland; brazil; morocco
agrobacterium tumefaciens	Bacteria	25	spain; france; chile; mexico; germany; australia; united states; russia; china; japan; poland; denmark; united kingdom; india; tunisia; south africa; algeria; cuba; egypt; morocco; bahamas; belgium; israel; thailand; kuwait
agrococcus baldri	Bacteria	1	austria
aichi virus	Virus	9	tunisia; bangladesh; japan; germany; china; france; brazil; australia; india
ajellomyces capsulatus	Fungi	24	uganda; japan; guinea; australia; brazil; mexico; united kingdom; panama; colombia; united states; china; thailand; guatemala; south africa; ecuador; argentina; indonesia; egypt; india; belgium; poland; nigeria; senegal; puerto rico
ajellomyces dermatitidis	Fungi	2	united states; canada
alloiococcus otitis	Bacteria	1	switzerland
alternaria alternata	Fungi	24	china; india; australia; switzerland; japan; spain; chile; antarctica; oman; united kingdom; united states; iran; puerto rico; italy; ecuador; sweden; austria; israel; brazil; mexico; saudi arabia; lithuania; greenland; czech republic
alternaria triticina	Fungi	1	iran
amblyomma dubitatum	Arthropod	3	uruguay; brazil; argentina
amblyomma tapirellum	Arthropod	1	panama
anaerostipes caccae	Bacteria	2	japan; sweden
anaplasma ovis	Bacteria	7	spain; united states; hungary; south africa; china; cyprus; turkey
anaplasma phagocytophilum	Bacteria	28	belarus; cyprus; tunisia; lithuania; united kingdom; japan; russia; turkey; italy; czech republic; poland; spain; united states; denmark; switzerland; china; slovenia; austria; albania; south korea; france; germany; estonia; argentina; latvia; norway; egypt; sweden
ancylostoma caninum	Helminth	2	laos; australia
ancylostoma ceylanicum	Helminth	4	malaysia; japan; laos; australia
ancylostoma duodenale	Helminth	4	tanzania; china; laos; australia
andes virus	Virus	7	brazil; venezuela; chile; paraguay; argentina; uruguay; bolivia
angiostrongylus cantonensis	Helminth	10	china; japan; spain; united states; brazil; taiwan; maldives; australia; french polynesia; reunion
angiostrongylus costaricensis	Helminth	2	costa rica; brazil
anisakis physeteris	Helminth	3	brazil; japan; italy
anisakis simplex	Helminth	10	poland; japan; south korea; united states; portugal; turkey; denmark; norway; greenland; spain
anoxybacillus pushchinoensis	Bacteria	3	turkey; tunisia; japan
apophysomyces elegans	Fungi	1	india
aquamicrobium lusatiense	Bacteria	2	russia; germany
arcanobacterium pyogenes	Bacteria	1	brazil
arcobacter butzleri	Bacteria	5	thailand; china; united states; spain; japan
arcobacter cryaerophilus	Bacteria	5	canada; united kingdom; ireland; china; belgium
arthrobacter creatinolyticus	Bacteria	2	canada; india
arthrobacter woluwensis	Bacteria	1	south korea
arthroderma benhamiae	Fungi	11	netherlands; united kingdom; kenya; belgium; iran; germany; japan; china; australia; new zealand; spain
arthroderma fulvum	Fungi	3	india; hungary; iran
arthroderma grubyi	Fungi	4	china; united states; canada; france
arthroderma gypseum	Fungi	7	iran; australia; oman; japan; brazil; switzerland; italy
arthroderma otae	Fungi	9	china; oman; costa rica; belgium; japan; brazil; united kingdom; iran; italy
arthroderma simii	Fungi	3	india; australia; japan
arthroderma vanbreuseghemii	Fungi	5	china; india; united kingdom; japan; iran
arthrographis kalrae	Fungi	8	south africa; australia; canada; united states; france; italy; india; japan
asaia bogorensis	Bacteria	1	lithuania
ascaris lumbricoides	Helminth	20	china; japan; germany; brazil; india; bangladesh; austria; panama; malaysia; guatemala; venezuela; kenya; egypt; nepal; nigeria; taiwan; tanzania; turkey; south africa; maldives
ascaris suum	Helminth	5	japan; switzerland; china; united states; united kingdom
aspergillus aculeatinus	Fungi	2	mexico; united states
aspergillus awamori	Fungi	6	netherlands; russia; india; czech republic; puerto rico; china
aspergillus calidoustus	Fungi	2	czech republic; spain
aspergillus candidus	Fungi	3	czech republic; romania; china
aspergillus carbonarius	Fungi	6	spain; czech republic; portugal; netherlands; italy; united states
aspergillus clavatus	Fungi	1	czech republic
aspergillus flavus	Fungi	16	india; brazil; tunisia; kuwait; colombia; czech republic; puerto rico; united states; china; egypt; mozambique; switzerland; oman; saudi arabia; nigeria; maldives
aspergillus fumigatus	Fungi	18	belarus; spain; brazil; belgium; sudan; ghana; czech republic; china; germany; japan; malaysia; india; united states; iraq; australia; egypt; united kingdom; maldives
aspergillus insuetus	Fungi	2	china; czech republic
aspergillus kanagawaensis	Fungi	1	czech republic
aspergillus lentulus	Fungi	2	czech republic; spain
aspergillus niger	Fungi	26	saudi arabia; sudan; india; australia; brazil; mexico; tunisia; canada; united kingdom; mali; colombia; kenya; united states; italy; china; mozambique; czech republic; puerto rico; france; oman; pakistan; vietnam; spain; egypt; nigeria; taiwan
aspergillus novofumigatus	Fungi	1	spain
aspergillus ochraceus	Fungi	7	uganda; china; united kingdom; democratic republic of the congo; united states; czech republic; colombia
aspergillus oryzae	Fungi	5	japan; malaysia; egypt; china; india
aspergillus penicillioides	Fungi	5	czech republic; japan; papua new guinea; brazil; indonesia
aspergillus persii	Fungi	1	czech republic
aspergillus sydowii	Fungi	8	china; colombia; puerto rico; russia; united states; japan; austria; czech republic
aspergillus tamarii	Fungi	8	egypt; czech republic; italy; india; spain; japan; puerto rico; colombia
aspergillus terreus	Fungi	14	india; china; egypt; oman; czech republic; russia; colombia; germany; vietnam; united states; puerto rico; iran; spain; senegal
aspergillus tritici	Fungi	1	czech republic
aspergillus tubingensis	Fungi	8	india; spain; germany; czech republic; united states; italy; mozambique; china
aspergillus unguis	Fungi	2	china; czech republic
aspergillus ustus	Fungi	5	china; canada; spain; russia; latvia
aspergillus versicolor	Fungi	13	iran; russia; lithuania; czech republic; china; spain; mali; australia; united kingdom; united states; puerto rico; india; colombia
aspergillus viridinutans	Fungi	3	china; czech republic; spain
aspergillus wentii	Fungi	1	czech republic
aspergillus westerdijkiae	Fungi	2	united states; czech republic
aurantimonas altamirensis	Bacteria	1	spain
aureobasidium pullulans	Fungi	22	poland; australia; spain; japan; iceland; germany; brazil; south korea; china; united states; united kingdom; niger; russia; portugal; latvia; italy; thailand; austria; switzerland; france; argentina; lithuania
australian bat lyssavirus	Virus	1	australia
babesia bovis	Protozoa	13	china; mexico; argentina; united states; thailand; syria; turkey; australia; portugal; brazil; spain; israel; italy
babesia divergens	Protozoa	11	poland; france; austria; switzerland; united kingdom; russia; ireland; finland; belgium; germany; united states
babesia duncani	Protozoa	1	united states
babesia gibsoni	Protozoa	9	taiwan; romania; south korea; united states; italy; japan; australia; turkey; spain
babesia microti	Protozoa	14	estonia; poland; china; japan; switzerland; germany; taiwan; south korea; united states; united kingdom; russia; austria; slovenia; spain
bacillus anthracis	Bacteria	19	south africa; france; china; india; united states; malaysia; italy; finland; south korea; cameroon; bulgaria; egypt; united kingdom; russia; canada; australia; haiti; united states minor outlying islands; maldives
bacillus aquimaris	Bacteria	8	china; india; thailand; malaysia; italy; indonesia; united states; romania
bacillus cereus	Bacteria	44	hungary; brazil; china; india; south korea; belgium; vietnam; taiwan; canada; bolivia; united kingdom; malaysia; united states; mexico; iran; italy; namibia; spain; netherlands; portugal; thailand; burkina faso; uruguay; japan; switzerland; ecuador; ireland; ivory coast; bahamas; sweden; austria; egypt; denmark; germany; france; norway; finland; mozambique; hong kong; qatar; pakistan; tunisia; argentina; maldives
bacillus clausii	Bacteria	6	india; china; italy; croatia; thailand; hungary
bacillus coagulans	Bacteria	9	chile; china; india; south korea; italy; netherlands; japan; south africa; mozambique
bacillus endophyticus	Bacteria	9	india; china; malaysia; kenya; israel; brazil; mexico; united states; mali
bacillus flexus	Bacteria	10	mexico; malaysia; belgium; iran; morocco; spain; china; india; vietnam; thailand
bacillus licheniformis	Bacteria	34	hungary; pakistan; china; india; qatar; taiwan; south korea; tunisia; united kingdom; nepal; malaysia; australia; united states; croatia; iran; turkey; italy; finland; portugal; thailand; uruguay; egypt; south africa; mozambique; canada; russia; france; mexico; germany; antarctica; netherlands; czech republic; israel; japan
bacillus megaterium	Bacteria	35	kenya; germany; france; china; india; south korea; taiwan; malaysia; mexico; united states; mali; iran; italy; finland; slovakia; netherlands; thailand; uruguay; japan; bahamas; hong kong; antarctica; morocco; indonesia; israel; portugal; colombia; poland; hungary; united kingdom; russia; argentina; pakistan; spain; romania
bacillus mojavensis	Bacteria	9	israel; tajikistan; india; hungary; united states; mexico; china; pakistan; russia
bacillus pumilus	Bacteria	37	hungary; pakistan; romania; antarctica; china; india; vietnam; tunisia; south korea; canada; united kingdom; nepal; russia; mexico; germany; malaysia; mali; united states; turkey; croatia; italy; spain; netherlands; thailand; uruguay; japan; argentina; morocco; austria; portugal; bahamas; greece; taiwan; egypt; iran; nigeria; finland
bacillus subtilis	Bacteria	46	tajikistan; ukraine; pakistan; china; finland; india; brazil; antarctica; israel; taiwan; south korea; vietnam; canada; united states; united kingdom; malaysia; nigeria; mexico; germany; mali; iran; turkey; croatia; italy; colombia; netherlands; spain; portugal; thailand; sweden; uruguay; japan; austria; egypt; argentina; tunisia; hungary; poland; bulgaria; kenya; france; russia; myanmar; algeria; indonesia; united states minor outlying islands
bacillus thioparans	Bacteria	3	israel; morocco; india
bacillus thuringiensis	Bacteria	39	sudan; hungary; syria; pakistan; china; ukraine; japan; antarctica; india; qatar; south korea; vietnam; canada; united kingdom; united states; malaysia; lebanon; germany; iran; tunisia; colombia; poland; mexico; portugal; thailand; uruguay; argentina; ireland; turkey; spain; israel; france; taiwan; russia; south africa; egypt; mozambique; brazil; australia
bacteroides caccae	Bacteria	1	spain
bacteroides dorei	Bacteria	3	japan; spain; sweden
bacteroides finegoldii	Bacteria	2	spain; japan
bacteroides fragilis	Bacteria	9	united kingdom; united states; japan; kuwait; spain; netherlands; france; sweden; taiwan
bacteroides ovatus	Bacteria	5	india; united kingdom; sweden; united states; spain
bacteroides thetaiotaomicron	Bacteria	2	united states; spain
bacteroides uniformis	Bacteria	4	germany; spain; japan; united states
bacteroides vulgatus	Bacteria	4	germany; denmark; india; united states
balamuthia mandrillaris	Protozoa	1	united states
balantidium coli	Protozoa	6	cameroon; philippines; spain; china; bolivia; czech republic
banna virus	Virus	1	china
barmah forest virus	Virus	1	australia
bartonella bacilliformis	Bacteria	2	peru; ecuador
bartonella elizabethae	Bacteria	5	vietnam; australia; thailand; georgia; china
bartonella henselae	Bacteria	10	new caledonia; united states; china; brazil; russia; france; chile; japan; australia; spain
bartonella quintana	Bacteria	4	united states; georgia; thailand; ethiopia
bartonella rochalimae	Bacteria	2	chile; united states
bartonella vinsonii	Bacteria	4	china; united states; russia; thailand
bartonella washoensis	Bacteria	2	austria; united states
baylisascaris procyonis	Helminth	3	china; united states; japan
bayou virus	Virus	1	united states
beauveria bassiana	Fungi	2	india; switzerland
bertiella studeri	Helminth	1	japan
betacoronavirus 1	Virus	13	china; hong kong; france; germany; united states; brazil; south korea; denmark; sweden; italy; greece; belgium; japan
bifidobacterium adolescentis	Bacteria	1	sweden
bifidobacterium animalis	Bacteria	3	austria; czech republic; france
bifidobacterium breve	Bacteria	2	italy; sweden
bifidobacterium catenulatum	Bacteria	1	india
bifidobacterium dentium	Bacteria	1	sweden
bifidobacterium longum	Bacteria	5	sweden; italy; united states; south korea; czech republic
bifidobacterium thermophilum	Bacteria	2	austria; czech republic
bilharziella polonica	Helminth	3	belarus; ukraine; france
bilophila wadsworthia	Bacteria	1	united states
bk polyomavirus	Virus	35	turkey; saudi arabia; kenya; central african republic; ethiopia; bulgaria; united kingdom; china; germany; taiwan; mauritania; niger; kuwait; italy; brazil; japan; iran; vietnam; greece; finland; ireland; hungary; south africa; cameroon; france; norway; philippines; united states; russia; myanmar; spain; south korea; mongolia; ghana; sweden
blastocystis hominis	Other Plant	11	denmark; thailand; united states; singapore; china; france; japan; germany; brazil; turkey; taiwan
blautia producta	Bacteria	1	india
bordetella bronchiseptica	Bacteria	9	sweden; mexico; germany; united kingdom; russia; china; france; denmark; argentina
bordetella hinzii	Bacteria	2	australia; laos
bordetella holmesii	Bacteria	2	united states; australia
bordetella parapertussis	Bacteria	1	france
bordetella pertussis	Bacteria	11	netherlands; united kingdom; china; canada; japan; united states; australia; france; argentina; russia; taiwan
bordetella petrii	Bacteria	3	united kingdom; india; germany
bordetella trematum	Bacteria	1	germany
borna disease virus	Virus	9	australia; egypt; austria; japan; netherlands; switzerland; germany; france; liechtenstein
borrelia afzelii	Bacteria	21	estonia; belarus; china; denmark; taiwan; portugal; poland; czech republic; slovakia; hungary; russia; south korea; germany; sweden; ukraine; serbia; turkey; slovenia; switzerland; japan; italy
borrelia americana	Bacteria	3	vietnam; czech republic; united states
borrelia andersonii	Bacteria	1	united states
borrelia bissettii	Bacteria	3	poland; united states; new zealand
borrelia burgdorferi	Bacteria	24	germany; italy; russia; china; united states; canada; france; czech republic; slovakia; taiwan; turkey; slovenia; serbia; egypt; morocco; poland; united kingdom; netherlands; austria; japan; sweden; brazil; spain; aland islands
borrelia crocidurae	Bacteria	1	senegal
borrelia duttonii	Bacteria	1	tanzania
borrelia garinii	Bacteria	19	china; poland; germany; switzerland; tunisia; czech republic; russia; latvia; italy; japan; turkey; taiwan; belarus; slovakia; france; south korea; denmark; slovenia; kazakhstan
borrelia hermsii	Bacteria	1	united states
borrelia hispanica	Bacteria	2	spain; japan
borrelia miyamotoi	Bacteria	5	sweden; russia; kazakhstan; united states; poland
borrelia persica	Bacteria	2	iran; israel
borrelia recurrentis	Bacteria	1	ethiopia
borrelia spielmanii	Bacteria	7	poland; denmark; czech republic; hungary; france; germany; switzerland
bothriocephalus acheilognathi	Helminth	8	china; south korea; panama; ethiopia; united kingdom; france; czech republic; united states
botryosphaeria dothidea	Fungi	18	china; australia; spain; malaysia; taiwan; switzerland; united states; italy; japan; south africa; slovenia; greece; zambia; new zealand; colombia; namibia; sri lanka; portugal
botryosphaeria rhodina	Fungi	20	uganda; papua new guinea; brazil; mexico; malaysia; zambia; nicaragua; canada; ecuador; united states; india; indonesia; puerto rico; south korea; cameroon; china; australia; south africa; ghana; egypt
bovine papular stomatitis virus	Virus	3	bangladesh; united states; japan
brachyspira aalborgi	Bacteria	3	norway; sweden; netherlands
brachyspira pilosicoli	Bacteria	7	sweden; hungary; finland; australia; united states; netherlands; norway
brevibacillus brevis	Bacteria	5	china; south korea; indonesia; malaysia; india
brevibacterium casei	Bacteria	3	argentina; mexico; israel
brevibacterium sanguinis	Bacteria	2	switzerland; belgium
brevundimonas diminuta	Bacteria	6	iran; japan; india; russia; spain; indonesia
brevundimonas vesicularis	Bacteria	7	china; united kingdom; south korea; mexico; india; united states; germany
brucella abortus	Bacteria	9	pakistan; india; united kingdom; turkey; chile; poland; italy; united states; trinidad and tobago
brucella canis	Bacteria	3	south africa; germany; united states
brucella melitensis	Bacteria	15	tanzania; france; saudi arabia; greece; cyprus; italy; mexico; united arab emirates; malaysia; china; india; palestinian territory; united states; united kingdom; iran
brucella suis	Bacteria	9	france; united states; finland; french polynesia; germany; wallis and futuna; india; bulgaria; australia
brugia malayi	Helminth	4	brazil; indonesia; india; thailand
brugia pahangi	Helminth	1	turkey
brugia timori	Helminth	1	indonesia
bunostomum trigonocephalum	Helminth	4	china; australia; france; united kingdom
bunyamwera virus	Virus	14	central african republic; panama; peru; united states; mexico; germany; kenya; india; japan; senegal; canada; ukraine; russia; cameroon
burkholderia cenocepacia	Bacteria	9	brazil; indonesia; japan; united kingdom; australia; india; israel; china; thailand
burkholderia cepacia	Bacteria	21	bulgaria; germany; italy; south korea; egypt; belgium; japan; china; france; nigeria; united kingdom; malaysia; india; indonesia; israel; vietnam; brazil; spain; taiwan; canada; united states
burkholderia endofungorum	Bacteria	2	japan; united states
burkholderia fungorum	Bacteria	11	india; czech republic; romania; italy; germany; israel; japan; morocco; united kingdom; france; brazil
burkholderia gladioli	Bacteria	3	china; mexico; italy
burkholderia mallei	Bacteria	6	myanmar; hungary; india; turkey; indonesia; thailand
burkholderia multivorans	Bacteria	3	united kingdom; india; finland
burkholderia pseudomallei	Bacteria	12	united states; singapore; italy; thailand; australia; bangladesh; malaysia; taiwan; china; brazil; maldives; hong kong
burkholderia rhizoxinica	Bacteria	1	united states
burkholderia stabilis	Bacteria	1	china
burkholderia tropica	Bacteria	5	brazil; mexico; south africa; china; australia
butyrivibrio fibrisolvens	Bacteria	5	united kingdom; czech republic; south africa; slovenia; australia
california encephalitis virus	Virus	8	somalia; czech republic; united states; russia; italy; china; kenya; canada
calyptrozyma arxii	Fungi	1	united states
camelpox virus	Virus	8	iran; somalia; india; kazakhstan; saudi arabia; united arab emirates; belgium; syria
campylobacter coli	Bacteria	16	sweden; italy; belgium; japan; canada; united states; bosnia and herzegovina; united kingdom; israel; slovenia; switzerland; australia; india; spain; poland; taiwan
campylobacter concisus	Bacteria	1	australia
campylobacter fetus	Bacteria	9	australia; argentina; china; japan; united kingdom; venezuela; united states; nigeria; canada
campylobacter gracilis	Bacteria	1	united kingdom
campylobacter hominis	Bacteria	1	united kingdom
campylobacter hyointestinalis	Bacteria	1	spain
campylobacter insulaenigrae	Bacteria	1	australia
campylobacter jejuni	Bacteria	24	finland; sweden; india; new zealand; china; japan; poland; puerto rico; united kingdom; thailand; singapore; taiwan; united states; spain; egypt; bangladesh; italy; australia; chile; greece; norway; canada; indonesia; nigeria
campylobacter lari	Bacteria	5	japan; canada; united states; united kingdom; france
campylobacter sputorum	Bacteria	1	spain
candida aaseri	Fungi	3	japan; norway; russia
candida albicans	Fungi	31	india; japan; spain; brazil; belgium; united kingdom; poland; russia; turkey; ireland; netherlands; china; ethiopia; angola; taiwan; madagascar; oman; united states; tanzania; australia; nigeria; south africa; italy; hong kong; tunisia; france; senegal; canada; singapore; maldives; micronesia
candida bracarensis	Fungi	1	portugal
candida catenulata	Fungi	2	portugal; united states
candida dubliniensis	Fungi	6	australia; france; ireland; argentina; china; united kingdom
candida ethanolica	Fungi	2	china; brazil
candida glabrata	Fungi	15	ethiopia; oman; belgium; united kingdom; kuwait; united states; thailand; indonesia; china; brazil; japan; ireland; russia; spain; taiwan
candida haemulonis	Fungi	1	panama
candida inconspicua	Fungi	3	netherlands; brazil; italy
candida intermedia	Fungi	5	portugal; norway; brazil; taiwan; china
candida membranifaciens	Fungi	4	iran; china; spain; thailand
candida metapsilosis	Fungi	2	thailand; australia
candida nivariensis	Fungi	2	spain; thailand
candida orthopsilosis	Fungi	4	india; thailand; brazil; australia
candida palmioleophila	Fungi	1	japan
candida parapsilosis	Fungi	14	india; brazil; united states; russia; portugal; china; thailand; guatemala; ireland; taiwan; ghana; japan; oman; spain
candida rugosa	Fungi	4	ghana; malaysia; thailand; india
candida tropicalis	Fungi	18	ethiopia; india; japan; oman; ghana; taiwan; malaysia; russia; iran; czech republic; portugal; china; brazil; thailand; ireland; spain; italy; pakistan
candida zeylanoides	Fungi	5	japan; russia; portugal; united states; india
capnocytophaga canimorsus	Bacteria	3	iran; japan; belgium
capnocytophaga granulosa	Bacteria	1	cyprus
capronia semiimmersa	Fungi	2	united states; france
caraparu virus	Virus	4	peru; brazil; panama; ecuador
carnobacterium divergens	Bacteria	4	united kingdom; denmark; egypt; south africa
catenulostroma chromoblastomycosum	Fungi	1	democratic republic of the congo
cedecea davisae	Bacteria	1	india
cellulosimicrobium cellulans	Bacteria	6	india; south korea; malaysia; iran; germany; pakistan
cellulosimicrobium funkei	Bacteria	1	new zealand
cellvibrio mixtus	Bacteria	1	australia
centrocestus formosanus	Helminth	1	canada
cephalotheca foveolata	Fungi	2	united states; south korea
cercopithecine herpesvirus 5	Virus	2	brazil; united states
ceriporia lacerata	Fungi	2	india; japan
chaetomium atrobrunneum	Fungi	1	india
chaetomium brasiliense	Fungi	2	united states; czech republic
chaetomium globosum	Fungi	12	uganda; czech republic; colombia; united states; china; india; spain; brazil; japan; jamaica; lithuania; canada
chalastospora gossypii	Fungi	3	iran; australia; united states
chandipura virus	Virus	1	india
chikungunya virus	Virus	27	india; senegal; malaysia; east timor; singapore; equatorial guinea; democratic republic of the congo; finland; bangladesh; sri lanka; indonesia; australia; seychelles; mauritius; united states; thailand; tanzania; france; china; colombia; reunion; italy; taiwan; maldives; comoros; nigeria; mayotte
chilomastix mesnili	Protozoa	1	turkey
chlamydia trachomatis	Bacteria	40	iceland; argentina; taiwan; united states; australia; russia; greece; spain; denmark; china; sweden; senegal; brazil; malaysia; papua new guinea; ireland; norway; peru; kenya; india; singapore; new zealand; france; netherlands; canada; bangladesh; tanzania; thailand; cameroon; benin; uganda; south africa; hong kong; japan; united kingdom; austria; saint helena; maldives; rwanda; french polynesia
chlamydophila abortus	Bacteria	7	greece; japan; tunisia; united kingdom; switzerland; united states; australia
chlamydophila felis	Bacteria	2	united states; italy
chlamydophila pneumoniae	Bacteria	13	central african republic; united states; switzerland; australia; canada; south korea; finland; united kingdom; iran; sweden; taiwan; china; singapore
chlamydophila psittaci	Bacteria	16	greece; sweden; argentina; antarctica; norway; france; faroe islands; iran; germany; japan; china; united states; netherlands; australia; ecuador; united kingdom
'chlorella' saccharophila	Green Algae	1	taiwan
chromobacterium violaceum	Bacteria	1	brazil
chryseobacterium indologenes	Bacteria	6	greece; burkina faso; united kingdom; india; italy; germany
citrobacter braakii	Bacteria	3	india; portugal; south korea
citrobacter freundii	Bacteria	21	argentina; germany; bangladesh; australia; bolivia; russia; china; italy; czech republic; france; portugal; denmark; spain; brazil; india; austria; japan; nepal; united kingdom; south korea; taiwan
citrobacter gillenii	Bacteria	2	chile; austria
citrobacter koseri	Bacteria	6	france; australia; china; italy; japan; india
cladophialophora bantiana	Fungi	1	united kingdom
cladophialophora carrionii	Fungi	3	venezuela; japan; australia
cladophialophora devriesii	Fungi	1	united kingdom
cladorrhinum bulbillosum	Fungi	1	egypt
cladosporium bruhnei	Fungi	5	china; germany; united states; russia; australia
cladosporium cladosporioides	Fungi	31	israel; south africa; uganda; china; india; greenland; brazil; antarctica; lithuania; austria; netherlands; france; taiwan; colombia; puerto rico; south korea; russia; latvia; germany; united states; japan; australia; zambia; oman; denmark; saudi arabia; thailand; czech republic; slovenia; mali; indonesia
cladosporium cucumerinum	Fungi	2	netherlands; united states
cladosporium oxysporum	Fungi	5	india; united states; slovenia; venezuela; china
cladosporium sphaerospermum	Fungi	6	lithuania; oman; united states; south korea; germany; austria
cladosporium velox	Fungi	1	venezuela
clavispora lusitaniae	Fungi	18	south africa; antigua and barbuda; venezuela; greece; italy; finland; china; brazil; thailand; mexico; australia; indonesia; netherlands; taiwan; portugal; turkey; germany; india
clinostomum complanatum	Helminth	2	italy; croatia
clonorchis sinensis	Helminth	7	china; vietnam; canada; south korea; russia; taiwan; hong kong
clostridium baratii	Bacteria	1	japan
clostridium botulinum	Bacteria	13	chad; greenland; canada; france; china; united states; denmark; japan; argentina; finland; hungary; italy; united kingdom
clostridium butyricum	Bacteria	3	colombia; china; sweden
clostridium celerecrescens	Bacteria	1	germany
clostridium clostridioforme	Bacteria	1	france
clostridium difficile	Bacteria	15	united states; belgium; united kingdom; iran; ireland; italy; canada; sweden; australia; slovenia; brazil; poland; france; taiwan; singapore
clostridium hiranonis	Bacteria	1	sweden
clostridium innocuum	Bacteria	3	italy; sweden; united kingdom
clostridium novyi	Bacteria	1	united kingdom
clostridium perfringens	Bacteria	15	india; south korea; czech republic; canada; united kingdom; australia; iran; japan; sweden; norway; china; italy; united states; french polynesia; maldives
clostridium septicum	Bacteria	6	china; germany; japan; united states; iran; italy
clostridium sordellii	Bacteria	1	italy
clostridium sporogenes	Bacteria	3	hungary; italy; india
coccidioides immitis	Fungi	3	japan; united states; mexico
coccidioides posadasii	Fungi	4	argentina; united states; japan; mexico
cochliobolus australiensis	Fungi	3	australia; united states; japan
cochliobolus cynodontis	Fungi	2	india; australia
cochliobolus geniculatus	Fungi	4	china; japan; myanmar; new caledonia
cochliobolus hawaiiensis	Fungi	1	oman
cochliobolus lunatus	Fungi	5	india; mexico; indonesia; brazil; japan
cochliobolus spicifer	Fungi	6	puerto rico; china; yemen; india; united states; united kingdom
cokeromyces recurvatus	Fungi	1	united states
colletotrichum dematium	Fungi	8	south africa; iran; japan; portugal; germany; mexico; bulgaria; czech republic
colletotrichum truncatum	Fungi	16	israel; india; pakistan; australia; brazil; bangladesh; canada; iran; nicaragua; united states; new zealand; nepal; sudan; tanzania; trinidad and tobago; china
collinsella aerofaciens	Bacteria	2	sweden; netherlands
comamonas testosteroni	Bacteria	8	germany; bangladesh; russia; japan; brazil; india; venezuela; china
conidiobolus coronatus	Fungi	2	india; hungary
conidiobolus lamprauges	Fungi	1	brazil
coprinellus domesticus	Fungi	5	panama; france; belgium; germany; mexico
coprinopsis cinerea	Fungi	4	japan; united kingdom; france; united states
cordyceps bassiana	Fungi	38	japan; cameroon; new zealand; switzerland; china; australia; india; kazakhstan; france; canada; hungary; costa rica; germany; south africa; united kingdom; colombia; bulgaria; belgium; spain; thailand; morocco; iran; united states; lithuania; philippines; syria; ivory coast; cuba; kyrgyzstan; brazil; turkey; austria; russia; uzbekistan; sweden; mexico; czech republic; italy
cordylobia anthropophaga	Arthropod	1	cameroon
corynebacterium afermentans	Bacteria	1	china
corynebacterium amycolatum	Bacteria	4	france; mexico; japan; switzerland
corynebacterium atypicum	Bacteria	1	united kingdom
corynebacterium bovis	Bacteria	1	china
corynebacterium diphtheriae	Bacteria	8	belarus; brazil; india; thailand; mayotte; united states; russia; united kingdom
corynebacterium jeikeium	Bacteria	1	iran
corynebacterium macginleyi	Bacteria	3	france; canada; japan
corynebacterium mastitidis	Bacteria	2	japan; switzerland
corynebacterium propinquum	Bacteria	5	canada; india; spain; thailand; france
corynebacterium pseudodiphtheriticum	Bacteria	4	germany; canada; united states; united kingdom
corynebacterium pseudotuberculosis	Bacteria	8	chile; israel; united kingdom; germany; italy; india; kenya; united states
corynebacterium stationis	Bacteria	1	china
corynebacterium striatum	Bacteria	2	china; united kingdom
corynebacterium tuberculostearicum	Bacteria	2	poland; brazil
corynebacterium ulcerans	Bacteria	3	japan; brazil; germany
corynebacterium urealyticum	Bacteria	1	china
corynebacterium xerosis	Bacteria	1	spain
cowpox virus	Virus	12	germany; austria; united kingdom; italy; finland; denmark; norway; luxembourg; sweden; russia; croatia; france
coxiella burnetii	Bacteria	14	japan; australia; russia; greece; china; brazil; egypt; iran; taiwan; spain; united kingdom; cyprus; canada; united states
crimean-congo hemorrhagic fever virus	Virus	21	turkey; bulgaria; turkmenistan; china; russia; nigeria; greece; south korea; uzbekistan; iraq; pakistan; namibia; kenya; iran; democratic republic of the congo; albania; uganda; south africa; egypt; kazakhstan; tajikistan
cronobacter malonaticus	Bacteria	3	egypt; united states; china
cronobacter sakazakii	Bacteria	8	iran; india; egypt; malaysia; south korea; germany; china; bangladesh
cronobacter turicensis	Bacteria	2	india; china
cryptendoxyla hypophloia	Fungi	1	oman
cryptococcus curvatus	Fungi	1	netherlands
cryptococcus gattii	Fungi	25	india; brazil; colombia; aruba; united states; china; mexico; japan; costa rica; france; puerto rico; taiwan; australia; venezuela; thailand; new zealand; netherlands; denmark; republic of the congo; uruguay; papua new guinea; south africa; canada; spain; italy
cryptococcus laurentii	Fungi	8	india; australia; brazil; antarctica; taiwan; china; thailand; russia
cryptococcus neoformans	Fungi	36	uganda; india; japan; australia; denmark; brazil; germany; united states; belgium; netherlands; china; france; argentina; switzerland; zambia; kuwait; botswana; canada; italy; united kingdom; south africa; portugal; egypt; latvia; tanzania; iran; costa rica; malawi; mexico; colombia; democratic republic of the congo; thailand; chile; singapore; taiwan; puerto rico
cryptosporidium andersoni	Protozoa	9	china; hungary; united states; canada; united kingdom; japan; egypt; brazil; czech republic
cryptosporidium bovis	Protozoa	4	united states; iran; china; egypt
cryptosporidium canis	Protozoa	5	italy; thailand; united kingdom; new zealand; brazil
cryptosporidium cuniculus	Protozoa	3	united kingdom; china; czech republic
cryptosporidium fayeri	Protozoa	1	india
cryptosporidium felis	Protozoa	8	united states; united kingdom; thailand; australia; brazil; colombia; china; czech republic
cryptosporidium hominis	Protozoa	28	uganda; egypt; hungary; australia; sweden; kuwait; saudi arabia; malaysia; ecuador; united states; china; thailand; new zealand; united kingdom; italy; kenya; chile; canada; cyprus; portugal; slovenia; jamaica; iran; turks and caicos islands; japan; yemen; india; mexico
cryptosporidium meleagridis	Protozoa	15	brazil; czech republic; thailand; kenya; hungary; iran; united kingdom; united states; china; chile; japan; peru; uganda; saudi arabia; malaysia
cryptosporidium muris	Protozoa	8	china; japan; australia; chile; united states; kenya; czech republic; saudi arabia
cryptosporidium parvum	Protozoa	48	iran; egypt; saudi arabia; cyprus; poland; china; india; romania; japan; spain; chile; united states; south africa; vietnam; nepal; canada; kuwait; malaysia; united kingdom; france; portugal; norway; brazil; uganda; sweden; jamaica; slovenia; new zealand; germany; thailand; nicaragua; italy; switzerland; hungary; malawi; yemen; ireland; australia; peru; israel; czech republic; mexico; denmark; kenya; nigeria; turkey; zambia; guatemala
cryptosporidium ubiquitum	Protozoa	3	canada; china; united kingdom
culex quinquefasciatus	Arthropod	22	zimbabwe; iran; mexico; india; taiwan; thailand; democratic republic of the congo; united states; bangladesh; china; brazil; zambia; french polynesia; south africa; mali; tanzania; ivory coast; burkina faso; trinidad and tobago; haiti; cuba; maldives
cupriavidus basilensis	Bacteria	4	india; japan; china; germany
cupriavidus taiwanensis	Bacteria	8	united states; taiwan; united kingdom; new caledonia; india; italy; french guiana; china
cyclospora cayetanensis	Protozoa	6	guatemala; china; haiti; peru; united states; nepal
cyphellophora laciniata	Fungi	1	japan
cystoisospora belli	Protozoa	2	japan; chile
debaryomyces fabryi	Fungi	4	china; thailand; france; germany
debaryomyces hansenii	Fungi	18	hungary; china; india; japan; australia; denmark; taiwan; belgium; russia; france; portugal; united states; netherlands; czech republic; united kingdom; germany; ireland; spain
debaryomyces subglobosus	Fungi	2	italy; austria
delftia acidovorans	Bacteria	10	india; united kingdom; hungary; united states; germany; italy; japan; pakistan; russia; spain
delftia tsuruhatensis	Bacteria	4	china; india; germany; mexico
demodex brevis	Arthropod	1	china
demodex folliculorum	Arthropod	2	china; spain
dengue virus	Virus	96	saudi arabia; uganda; burkina faso; iceland; guatemala; aruba; samoa; niue; saint vincent and the grenadines; mexico; guam; british virgin islands; curacao; bhutan; china; australia; fiji; east timor; taiwan; nepal; united states; venezuela; papua new guinea; chile; argentina; micronesia; vietnam; dominican republic; mozambique; brazil; japan; singapore; india; myanmar; new caledonia; thailand; nicaragua; colombia; peru; indonesia; honduras; barbados; puerto rico; montserrat; philippines; grenada; belize; guadeloupe; south korea; ecuador; bangladesh; cambodia; paraguay; french guiana; suriname; sri lanka; american samoa; malaysia; guyana; martinique; costa rica; senegal; cameroon; dominica; yemen; el salvador; kiribati; pakistan; haiti; solomon islands; french polynesia; france; ivory coast; jamaica; bahamas; djibouti; bolivia; brunei; cook islands; antigua and barbuda; croatia; cuba; saint lucia; trinidad and tobago; maldives; spain; nigeria; angola; saint kitts and nevis; hungary; tonga; madagascar; anguilla; panama; italy; reunion
dermatophilus congolensis	Bacteria	2	australia; united kingdom
desmospora activa	Bacteria	1	taiwan
dialister micraerophilus	Bacteria	1	finland
dicrocoelium dendriticum	Helminth	2	iran; spain
dictyostelium discoideum	Protozoa	2	japan; united states
dientamoeba fragilis	Protozoa	3	france; iran; australia
dietzia maris	Bacteria	6	kuwait; united states; china; brazil; united kingdom; spain
dietzia natronolimnaea	Bacteria	7	portugal; hungary; united states; india; china; kuwait; spain
dietzia timorensis	Bacteria	1	spain
dioctophyme renale	Helminth	1	canada
diphyllobothrium dendriticum	Helminth	3	estonia; united kingdom; switzerland
diphyllobothrium latum	Helminth	6	estonia; switzerland; france; finland; brazil; chile
diphyllobothrium nihonkaiense	Helminth	3	switzerland; japan; canada
diphyllobothrium pacificum	Helminth	2	chile; peru
diplogonoporus balaenopterae	Helminth	1	japan
dipodascus capitatus	Fungi	2	oman; south korea
dirofilaria immitis	Helminth	11	china; australia; france; italy; japan; india; turkey; united states; brazil; taiwan; french polynesia
dirofilaria repens	Helminth	4	albania; china; italy; france
dirofilaria tenuis	Helminth	1	united states
dobrava-belgrade virus	Virus	13	estonia; romania; slovakia; czech republic; russia; germany; croatia; denmark; pakistan; greece; bulgaria; slovenia; hungary
dracunculus medinensis	Helminth	1	ghana
dugbe virus	Virus	3	india; south korea; kenya
duvenhage virus	Virus	2	zimbabwe; south africa
eastern equine encephalitis virus	Virus	13	china; united states; trinidad and tobago; mexico; argentina; peru; panama; guyana; brazil; guatemala; ecuador; colombia; venezuela
echinococcus canadensis	Helminth	16	finland; iran; kenya; argentina; canada; ethiopia; united states; mauritania; slovakia; algeria; italy; peru; romania; poland; estonia; china
echinococcus granulosus	Helminth	33	iran; china; romania; brazil; chile; india; tunisia; argentina; united kingdom; peru; mauritania; portugal; italy; uruguay; turkey; falkland islands; algeria; nepal; egypt; jordan; austria; poland; hungary; slovakia; bulgaria; australia; ethiopia; russia; sudan; kenya; cyprus; canada; united states
echinococcus multilocularis	Helminth	15	poland; hungary; china; romania; japan; germany; united states; slovakia; mongolia; austria; united kingdom; spain; estonia; switzerland; france
echinococcus oligarthrus	Helminth	1	panama
echinococcus vogeli	Helminth	1	colombia
echinoparyphium recurvatum	Helminth	1	united kingdom
echinostoma revolutum	Helminth	3	bulgaria; united kingdom; united states
edwardsiella tarda	Bacteria	5	india; mexico; china; lithuania; united states
eggerthella lenta	Bacteria	1	united kingdom
ehrlichia canis	Bacteria	14	argentina; united states; nigeria; cape verde; italy; china; cameroon; brazil; venezuela; japan; turkey; malaysia; taiwan; spain
ehrlichia chaffeensis	Bacteria	3	united states; china; brazil
ehrlichia ewingii	Bacteria	2	united states; brazil
ehrlichia ruminantium	Bacteria	6	ethiopia; sudan; antigua and barbuda; south africa; namibia; united states
eikenella corrodens	Bacteria	1	india
elizabethkingia meningoseptica	Bacteria	3	china; india; taiwan
emericella nidulans	Fungi	9	germany; china; united kingdom; united states; russia; czech republic; japan; india; south korea
emericella rugulosa	Fungi	2	czech republic; mexico
encephalitozoon cuniculi	Fungi	6	australia; austria; united kingdom; japan; iran; czech republic
encephalitozoon hellem	Fungi	1	china
encephalitozoon intestinalis	Fungi	5	australia; pakistan; russia; iran; canada
encephalomyocarditis virus	Virus	8	china; belgium; democratic republic of the congo; italy; greece; cyprus; united states; singapore
engyodontium album	Fungi	3	china; austria; spain
entamoeba coli	Protozoa	11	vietnam; nigeria; malawi; germany; belgium; brazil; japan; peru; cyprus; turkey; taiwan
entamoeba dispar	Protozoa	1	iran
entamoeba hartmanni	Protozoa	1	united kingdom
entamoeba histolytica	Protozoa	24	iran; india; china; japan; mexico; united states; united kingdom; burkina faso; bangladesh; brazil; thailand; philippines; cambodia; venezuela; vietnam; ghana; indonesia; saudi arabia; ethiopia; taiwan; nigeria; australia; maldives; democratic republic of the congo
entamoeba moshkovskii	Protozoa	1	india
entamoeba polecki	Protozoa	5	somalia; denmark; kenya; sweden; ethiopia
enterobacter aerogenes	Bacteria	13	pakistan; mexico; south korea; russia; italy; thailand; brazil; india; malaysia; hong kong; china; japan; spain
enterobacter amnigenus	Bacteria	5	united states; netherlands; slovakia; finland; china
enterobacter asburiae	Bacteria	10	india; china; spain; united kingdom; germany; mexico; united states; south korea; gabon; italy
enterobacter cancerogenus	Bacteria	5	india; malaysia; united states; morocco; china
enterobacter cloacae	Bacteria	22	india; pakistan; sweden; netherlands; argentina; germany; mexico; china; italy; japan; slovakia; france; czech republic; portugal; united states; malaysia; austria; algeria; brazil; russia; taiwan; united kingdom
enterobacter hormaechei	Bacteria	6	china; hong kong; germany; mexico; malaysia; india
enterobacter kobei	Bacteria	2	china; germany
enterobacter ludwigii	Bacteria	9	china; malaysia; slovakia; uruguay; mexico; germany; brazil; india; kenya
enterobius vermicularis	Helminth	10	malaysia; sudan; chile; south korea; china; brazil; japan; united states; taiwan; turkey
enterococcus avium	Bacteria	2	denmark; japan
enterococcus casseliflavus	Bacteria	9	malaysia; taiwan; nigeria; united states; india; japan; pakistan; denmark; italy
enterococcus durans	Bacteria	8	spain; iran; india; china; japan; italy; united states; russia
enterococcus faecalis	Bacteria	28	hungary; pakistan; brazil; china; lithuania; tunisia; south korea; germany; india; nigeria; united states; spain; iran; portugal; thailand; japan; uganda; france; sweden; chile; italy; denmark; taiwan; united kingdom; singapore; australia; maldives; hong kong
enterococcus faecium	Bacteria	32	pakistan; brazil; china; india; greece; south korea; ghana; taiwan; tunisia; united kingdom; united states; nigeria; russia; germany; mexico; spain; iran; italy; france; thailand; norway; japan; argentina; netherlands; uganda; turkey; denmark; canada; ireland; georgia; portugal; singapore
enterococcus gallinarum	Bacteria	6	china; india; united states; sweden; norway; nigeria
enterococcus gilvus	Bacteria	1	japan
enterococcus hirae	Bacteria	6	spain; argentina; uganda; japan; united states; brazil
enterococcus italicus	Bacteria	3	china; italy; ghana
enterococcus mundtii	Bacteria	3	united states; japan; india
enterococcus raffinosus	Bacteria	2	iran; spain
enterococcus thailandicus	Bacteria	1	china
enterocytozoon bieneusi	Fungi	15	uganda; iran; china; cameroon; gabon; united kingdom; tunisia; czech republic; peru; united states; thailand; japan; united arab emirates; australia; kenya
epicoccum nigrum	Fungi	17	estonia; china; antarctica; switzerland; latvia; sweden; spain; colombia; austria; united states; australia; japan; brazil; czech republic; ecuador; lithuania; serbia
epidermophyton floccosum	Fungi	7	iran; oman; united kingdom; australia; france; bolivia; italy
escherichia albertii	Bacteria	5	brazil; germany; bangladesh; japan; australia
escherichia coli	Bacteria	93	kenya; sudan; iran; hungary; somalia; india; pakistan; japan; nigeria; netherlands; argentina; germany; united states; gabon; united kingdom; australia; bangladesh; new zealand; bolivia; peru; russia; greece; canada; italy; mexico; poland; czech republic; slovakia; malaysia; portugal; denmark; thailand; uruguay; central african republic; spain; switzerland; brazil; norway; croatia; egypt; tunisia; south africa; saudi arabia; china; france; sweden; austria; indonesia; cuba; venezuela; singapore; uganda; israel; ireland; romania; nepal; taiwan; tanzania; vietnam; south korea; belgium; finland; hong kong; chile; cameroon; senegal; mali; morocco; guatemala; puerto rico; turkey; zimbabwe; nicaragua; lebanon; ethiopia; ghana; colombia; guinea-bissau; trinidad and tobago; madagascar; new caledonia; libya; burkina faso; algeria; haiti; panama; united states minor outlying islands; maldives; micronesia; solomon islands; saint helena; guam; french polynesia
eubacterium brachy	Bacteria	1	united kingdom
eubacterium hallii	Bacteria	1	india
eubacterium infirmum	Bacteria	1	austria
european bat lyssavirus 1	Virus	6	poland; netherlands; germany; spain; denmark; france
european bat lyssavirus 2	Virus	5	united kingdom; switzerland; finland; netherlands; germany
eurotium amstelodami	Fungi	6	india; australia; germany; czech republic; china; austria
eurytrema pancreaticum	Helminth	1	china
ewingella americana	Bacteria	2	new zealand; kenya
exophiala dermatitidis	Fungi	1	japan
exophiala jeanselmei	Fungi	1	japan
exophiala spinifera	Fungi	2	brazil; japan
faecalibacterium prausnitzii	Bacteria	3	netherlands; india; united kingdom
fasciola gigantica	Helminth	20	tanzania; iran; senegal; burkina faso; egypt; niger; zambia; vietnam; india; turkey; china; indonesia; thailand; australia; south korea; cape verde; mauritania; myanmar; united states; maldives
fasciola hepatica	Helminth	26	iran; saudi arabia; egypt; china; japan; australia; spain; greece; turkey; tunisia; bolivia; united kingdom; peru; niger; ireland; france; uruguay; algeria; austria; south korea; netherlands; cuba; thailand; puerto rico; canada; united states
fasciolopsis buski	Helminth	2	india; vietnam
finegoldia magna	Bacteria	1	japan
flavobacterium lindanitolerans	Bacteria	1	china
flavonifractor plautii	Bacteria	2	united kingdom; sweden
fluoribacter dumoffii	Bacteria	1	germany
fonsecaea monophora	Fungi	2	japan; brazil
fonsecaea pedrosoi	Fungi	13	china; cameroon; argentina; venezuela; colombia; brazil; japan; republic of the congo; costa rica; mozambique; madagascar; australia; maldives
foot-and-mouth disease virus	Virus	90	greece; uganda; israel; zimbabwe; iran; swaziland; vietnam; china; malawi; south korea; spain; cameroon; senegal; morocco; gambia; angola; namibia; argentina; bahrain; eritrea; egypt; oman; burundi; india; thailand; bhutan; qatar; japan; malaysia; algeria; italy; netherlands; taiwan; sudan; ethiopia; united kingdom; lebanon; saudi arabia; hong kong; zambia; myanmar; botswana; singapore; peru; democratic republic of the congo; colombia; ireland; philippines; turkey; russia; cambodia; bangladesh; belgium; germany; sri lanka; kenya; south africa; uruguay; indonesia; laos; mali; iraq; pakistan; france; afghanistan; united arab emirates; poland; libya; ghana; syria; venezuela; nigeria; brazil; guinea; yemen; burkina faso; denmark; kuwait; jordan; palestinian territory; tunisia; switzerland; nepal; mozambique; tanzania; austria; ivory coast; rwanda; ecuador; united states
francisella tularensis	Bacteria	6	japan; united states; hungary; sweden; spain; canada
fusarium chlamydosporum	Fungi	10	argentina; mexico; nicaragua; japan; brazil; india; south korea; china; australia; spain
fusarium falciforme	Fungi	3	mexico; united states; japan
fusarium incarnatum	Fungi	9	china; chile; indonesia; india; italy; bahamas; vietnam; japan; nicaragua
fusarium napiforme	Fungi	2	italy; mexico
fusarium oxysporum	Fungi	41	tanzania; saudi arabia; india; china; australia; japan; spain; mexico; united states; vietnam; south korea; netherlands; canada; taiwan; russia; czech republic; kenya; philippines; honduras; italy; brazil; lithuania; south africa; ecuador; ivory coast; algeria; austria; france; egypt; greece; israel; germany; indonesia; malaysia; thailand; colombia; nigeria; afghanistan; costa rica; finland; chile
fusarium polyphialidicum	Fungi	3	mexico; brazil; spain
fusarium sacchari	Fungi	4	mexico; united states; india; indonesia
fusarium solani	Fungi	47	comoros; china; south korea; japan; cameroon; germany; brazil; bolivia; united states; peru; sri lanka; portugal; australia; argentina; saudi arabia; dominican republic; cyprus; canada; cape verde; mexico; italy; costa rica; taiwan; united kingdom; south africa; france; cambodia; indonesia; french guiana; spain; norway; ecuador; russia; malaysia; philippines; india; kenya; cuba; egypt; colombia; qatar; benin; austria; thailand; netherlands; bulgaria; turkey
fusarium subglutinans	Fungi	6	israel; south africa; china; united states; brazil; mexico
fusobacterium gonidiaformans	Bacteria	1	united kingdom
fusobacterium necrophorum	Bacteria	2	china; india
fusobacterium nucleatum	Bacteria	7	china; netherlands; united states; switzerland; sweden; comoros; germany
fusobacterium periodonticum	Bacteria	3	germany; china; india
fusobacterium ulcerans	Bacteria	1	united kingdom
gardnerella vaginalis	Bacteria	3	france; india; lithuania
gemella haemolysans	Bacteria	2	spain; sweden
geosmithia argillacea	Fungi	2	india; france
giardia intestinalis	Protozoa	32	iran; ethiopia; poland; china; india; japan; australia; spain; cuba; germany; mexico; united states; tunisia; belgium; south korea; canada; united kingdom; guinea-bissau; croatia; czech republic; bangladesh; denmark; italy; burkina faso; brazil; thailand; sweden; new zealand; taiwan; egypt; venezuela; turkey
gibberella intermedia	Fungi	18	iran; italy; colombia; antarctica; ecuador; china; india; malaysia; south korea; united states; taiwan; japan; spain; serbia; peru; indonesia; ivory coast; burkina faso
gibberella moniliformis	Fungi	15	china; italy; united states; bangladesh; iran; spain; mexico; ecuador; india; ivory coast; brazil; south korea; nicaragua; france; colombia
gnathostoma binucleatum	Helminth	2	mexico; ecuador
gnathostoma doloresi	Helminth	1	japan
gnathostoma nipponicum	Helminth	1	japan
gnathostoma spinigerum	Helminth	6	china; japan; thailand; philippines; united states; indonesia
gongylonema pulchrum	Helminth	2	iran; japan
gordonia terrae	Bacteria	3	south korea; germany; japan
granulicatella adiacens	Bacteria	1	united kingdom
grimontia hollisae	Bacteria	2	japan; bangladesh
guanarito virus	Virus	1	venezuela
haemonchus contortus	Helminth	15	egypt; iran; china; australia; india; united states; united kingdom; france; democratic republic of the congo; malaysia; yemen; mongolia; italy; netherlands; u.s. virgin islands
haemophilus ducreyi	Bacteria	4	kenya; rwanda; united kingdom; united states
haemophilus haemolyticus	Bacteria	1	denmark
haemophilus influenzae	Bacteria	37	kenya; united kingdom; russia; canada; italy; finland; denmark; spain; sweden; united states; netherlands; china; australia; south africa; nigeria; switzerland; chile; egypt; thailand; turkey; senegal; papua new guinea; brazil; hong kong; norway; mexico; saudi arabia; malawi; singapore; bangladesh; taiwan; philippines; japan; mali; france; maldives; french polynesia
haemophilus parahaemolyticus	Bacteria	2	germany; denmark
haemophilus parainfluenzae	Bacteria	4	denmark; spain; brazil; south africa
hafnia alvei	Bacteria	4	germany; france; japan; united kingdom
hantaan virus	Virus	3	china; russia; south korea
haplorchis pumilio	Helminth	2	vietnam; thailand
haplorchis taichui	Helminth	3	thailand; laos; vietnam
haplorchis yokogawai	Helminth	1	thailand
helicobacter cinaedi	Bacteria	1	south africa
helicobacter pullorum	Bacteria	2	united states; austria
helicobacter pylori	Bacteria	60	kenya; iran; belarus; finland; netherlands; chile; italy; lithuania; india; bangladesh; vietnam; senegal; new zealand; peru; china; japan; united states; philippines; brazil; colombia; poland; france; uruguay; united kingdom; costa rica; ireland; south africa; guatemala; thailand; gambia; argentina; hong kong; portugal; australia; turkey; cambodia; singapore; russia; greece; kazakhstan; south korea; taiwan; venezuela; malaysia; norway; germany; spain; mexico; sweden; estonia; canada; belgium; saudi arabia; pakistan; indonesia; panama; denmark; french polynesia; bonaire, saint eustatius and saba ; maldives
hendra virus	Virus	2	australia; japan
hepatitis a virus	Virus	42	estonia; china; argentina; thailand; india; japan; algeria; netherlands; norway; canada; united kingdom; chile; united states; tunisia; hungary; singapore; russia; south korea; albania; germany; italy; brazil; sierra leone; ukraine; turkey; mexico; belarus; uruguay; spain; morocco; cuba; france; hong kong; venezuela; finland; egypt; indonesia; taiwan; saudi arabia; australia; greece; maldives
hepatitis b virus	Virus	122	turkey; belarus; central african republic; israel; estonia; uganda; morocco; gambia; angola; canada; samoa; gabon; indonesia; netherlands; belgium; germany; japan; united states; taiwan; nepal; lebanon; hong kong; portugal; micronesia; papua new guinea; nigeria; mali; venezuela; iran; india; mexico; greece; myanmar; brazil; kazakhstan; czech republic; vietnam; singapore; italy; colombia; nicaragua; equatorial guinea; democratic republic of the congo; ireland; egypt; peru; hungary; philippines; ecuador; bangladesh; cambodia; mongolia; latvia; uruguay; russia; south africa; martinique; costa rica; cameroon; uzbekistan; laos; yemen; tonga; syria; sierra leone; china; france; ivory coast; pakistan; solomon islands; argentina; united arab emirates; bolivia; new zealand; afghanistan; kenya; chile; kiribati; united kingdom; malawi; malaysia; somalia; ghana; madagascar; south korea; mauritania; rwanda; el salvador; spain; namibia; australia; kuwait; ethiopia; iraq; serbia; togo; burkina faso; vanuatu; fiji; thailand; norway; niger; bulgaria; benin; zimbabwe; panama; sweden; haiti; tajikistan; tanzania; turkmenistan; saudi arabia; sudan; poland; french polynesia; denmark; puerto rico; switzerland; senegal; cuba; republic of the congo; maldives
hepatitis c virus	Virus	87	saudi arabia; turkey; iran; rwanda; democratic republic of the congo; somalia; china; romania; hong kong; spain; morocco; denmark; cameroon; ireland; brazil; argentina; mexico; france; egypt; pakistan; gabon; algeria; malaysia; russia; netherlands; thailand; austria; germany; united states; canada; taiwan; venezuela; united kingdom; portugal; kuwait; new zealand; italy; vietnam; myanmar; czech republic; australia; peru; colombia; madagascar; hungary; philippines; poland; south korea; belgium; bosnia and herzegovina; cambodia; india; costa rica; martinique; laos; syria; chile; japan; andorra; indonesia; republic of the congo; south africa; estonia; central african republic; sweden; burundi; ghana; uruguay; cuba; belarus; uganda; equatorial guinea; tunisia; cyprus; bangladesh; nigeria; greece; puerto rico; burkina faso; kenya; singapore; nepal; mongolia; senegal; macao; afghanistan; maldives
hepatitis delta virus	Virus	32	somalia; iran; romania; guinea; cameroon; gambia; angola; japan; gabon; italy; canada; venezuela; ghana; poland; democratic republic of the congo; russia; brazil; mali; ivory coast; turkey; china; argentina; republic of the congo; france; mongolia; ethiopia; taiwan; pakistan; central african republic; egypt; senegal; united kingdom
hepatitis e virus	Virus	50	poland; china; india; spain; germany; namibia; argentina; united states; canada; egypt; thailand; japan; algeria; austria; italy; croatia; australia; united kingdom; new zealand; pakistan; vietnam; new caledonia; hungary; democratic republic of the congo; russia; bangladesh; israel; south africa; brazil; indonesia; czech republic; sweden; nepal; france; djibouti; kyrgyzstan; serbia; central african republic; mexico; morocco; slovenia; south korea; cuba; uruguay; belgium; afghanistan; cambodia; taiwan; chad; hong kong
herminiimonas saxobsidens	Bacteria	1	turkey
heterobilharzia americana	Helminth	1	united states
hortaea werneckii	Fungi	4	germany; spain; china; slovenia
human adenovirus a	Virus	5	canada; united states; germany; australia; japan
human adenovirus b	Virus	24	israel; japan; morocco; austria; united kingdom; portugal; south korea; australia; united states; mexico; taiwan; saudi arabia; ireland; thailand; canada; malaysia; turkey; italy; netherlands; china; egypt; singapore; spain; argentina
human adenovirus c	Virus	21	japan; morocco; united kingdom; united states; iran; brazil; hungary; paraguay; germany; azerbaijan; mexico; russia; malaysia; south africa; argentina; armenia; china; egypt; vietnam; taiwan; italy
human adenovirus d	Virus	15	south africa; japan; germany; saudi arabia; canada; united states; paraguay; australia; turkey; slovenia; china; morocco; russia; argentina; hungary
human adenovirus e	Virus	5	japan; united states; china; turkey; south korea
human adenovirus f	Virus	15	iran; south africa; united kingdom; south korea; taiwan; japan; brazil; thailand; russia; china; morocco; tunisia; india; germany; bangladesh
human adenovirus g	Virus	1	united states
human astrovirus	Virus	21	iran; central african republic; south africa; china; cameroon; japan; australia; brazil; argentina; mexico; russia; colombia; hungary; bangladesh; kenya; india; syria; mongolia; italy; madagascar; united kingdom
human coronavirus 229e	Virus	7	thailand; netherlands; brazil; japan; australia; greece; italy
human coronavirus hku1	Virus	7	brazil; hong kong; china; south korea; sweden; france; australia
human coronavirus nl63	Virus	11	china; hong kong; belgium; sweden; france; south korea; united states; netherlands; japan; australia; greece
human enterovirus a	Virus	46	egypt; bulgaria; iran; india; vietnam; china; iceland; denmark; germany; australia; lithuania; malaysia; netherlands; nigeria; france; taiwan; united kingdom; greece; russia; cyprus; canada; finland; hungary; ireland; south korea; cambodia; latvia; mongolia; kenya; turkey; spain; croatia; japan; brazil; sweden; georgia; austria; brunei; singapore; thailand; switzerland; italy; saudi arabia; democratic republic of the congo; united states; slovakia
human enterovirus b	Virus	72	belarus; greece; cyprus; kenya; estonia; democratic republic of the congo; china; poland; romania; india; australia; japan; spain; denmark; morocco; burkina faso; united kingdom; germany; argentina; united states; oman; russia; egypt; pakistan; nigeria; algeria; france; ethiopia; belgium; netherlands; italy; taiwan; canada; switzerland; libya; tunisia; hong kong; dominican republic; finland; costa rica; madagascar; hungary; panama; south korea; bangladesh; cambodia; mongolia; latvia; azerbaijan; turkey; croatia; brazil; austria; uzbekistan; georgia; cuba; ukraine; singapore; lithuania; ecuador; moldova; honduras; sweden; iran; israel; kyrgyzstan; ireland; jordan; iraq; mexico; czech republic; jamaica
human enterovirus c	Virus	75	israel; central african republic; belarus; somalia; china; cameroon; liberia; chad; morocco; australia; italy; guatemala; cuba; india; japan; netherlands; taiwan; nigeria; united kingdom; sudan; pakistan; egypt; zambia; tunisia; united states; greece; vietnam; dominican republic; cyprus; colombia; madagascar; democratic republic of the congo; malaysia; russia; south korea; bangladesh; cambodia; mongolia; ecuador; finland; argentina; south africa; turkey; brazil; nicaragua; indonesia; senegal; benin; iraq; armenia; syria; france; ivory coast; georgia; singapore; afghanistan; canada; burkina faso; angola; hong kong; philippines; kenya; nepal; ghana; denmark; french guiana; turkmenistan; germany; niger; laos; mexico; iran; palestinian territory; guadeloupe; maldives
human enterovirus d	Virus	12	egypt; australia; brazil; japan; netherlands; new zealand; italy; united states; democratic republic of the congo; india; taiwan; singapore
human herpesvirus 1	Virus	16	japan; sweden; germany; south korea; united states; united kingdom; slovakia; spain; france; china; india; netherlands; kenya; australia; singapore; taiwan
human herpesvirus 2	Virus	19	japan; sweden; united states; nigeria; iran; jamaica; russia; zimbabwe; united kingdom; france; netherlands; tanzania; south africa; china; kenya; australia; uganda; india; mexico
human herpesvirus 3	Virus	16	south korea; germany; united states; india; ireland; russia; colombia; mongolia; japan; australia; united kingdom; spain; brazil; singapore; maldives; taiwan
human herpesvirus 4	Virus	20	australia; hong kong; italy; malaysia; china; france; slovenia; japan; taiwan; serbia; argentina; russia; united kingdom; singapore; thailand; canada; united states; mexico; brazil; french polynesia
human herpesvirus 5	Virus	16	malawi; south korea; austria; germany; australia; united states; united kingdom; india; iran; thailand; italy; spain; china; france; netherlands; taiwan
human herpesvirus 6	Virus	6	india; japan; brazil; democratic republic of the congo; china; uganda
human herpesvirus 7	Virus	4	united states; hong kong; japan; thailand
human herpesvirus 8	Virus	39	central african republic; iran; zimbabwe; senegal; cameroon; cuba; taiwan; new zealand; saudi arabia; kuwait; botswana; greece; italy; new caledonia; peru; gabon; united states; ecuador; french guiana; brazil; japan; solomon islands; haiti; russia; republic of the congo; democratic republic of the congo; france; south africa; china; united kingdom; malawi; israel; hungary; gambia; argentina; uganda; australia; zambia; netherlands
human immunodeficiency virus 1	Virus	159	kenya; belarus; tanzania; democratic republic of the congo; turkey; uganda; ethiopia; bulgaria; cyprus; rwanda; seychelles; zimbabwe; china; malawi; romania; australia; burkina faso; spain; switzerland; chad; guinea; angola; antigua and barbuda; saint vincent and the grenadines; argentina; saint lucia; mexico; cuba; curacao; united kingdom; india; burundi; eritrea; russia; algeria; netherlands; austria; thailand; gabon; malaysia; belgium; lithuania; germany; italy; canada; nepal; niger; portugal; zambia; sudan; new zealand; iran; chile; libya; lebanon; venezuela; ghana; vietnam; greece; botswana; mozambique; kazakhstan; czech republic; dominican republic; tunisia; poland; honduras; myanmar; slovakia; peru; cape verde; equatorial guinea; ireland; hungary; panama; guadeloupe; philippines; puerto rico; south korea; mongolia; croatia; ecuador; bangladesh; latvia; azerbaijan; french guiana; south africa; martinique; guyana; brazil; costa rica; indonesia; senegal; sweden; cameroon; uzbekistan; trinidad and tobago; dominica; yemen; sierra leone; guinea-bissau; ukraine; france; haiti; ivory coast; jamaica; united states; georgia; djibouti; bahamas; republic of the congo; bolivia; slovenia; luxembourg; afghanistan; morocco; japan; benin; israel; liberia; cambodia; saint martin; central african republic; mali; el salvador; mauritius; colombia; denmark; finland; egypt; taiwan; uruguay; estonia; gambia; barbados; nigeria; albania; grenada; norway; hong kong; montserrat; pakistan; suriname; saudi arabia; singapore; somalia; fiji; paraguay; papua new guinea; solomon islands; new caledonia; french polynesia; samoa; guatemala; united states minor outlying islands; guam; togo; maldives; micronesia
human immunodeficiency virus 2	Virus	109	burkina faso; spain; guinea; belgium; portugal; united kingdom; togo; guinea-bissau; ghana; cape verde; colombia; equatorial guinea; italy; senegal; sweden; ivory coast; united states; gambia; cameroon; brazil; india; algeria; mali; luxembourg; angola; venezuela; france; netherlands; sri lanka; mauritania; martinique; nigeria; somalia; tanzania; democratic republic of the congo; uganda; egypt; mauritius; mozambique; philippines; china; hong kong; japan; russia; australia; switzerland; germany; croatia; cuba; guatemala; panama; peru; french polynesia; iran; ukraine; zimbabwe; botswana; bangladesh; thailand; new caledonia; benin; gabon; uruguay; haiti; indonesia; solomon islands; republic of the congo; rwanda; israel; greece; south africa; saudi arabia; kenya; malawi; pakistan; cambodia; singapore; papua new guinea; norway; argentina; mexico; guam; canada; cyprus; ethiopia; zambia; malaysia; fiji; denmark; austria; trinidad and tobago; el salvador; chile; samoa; puerto rico; burundi; estonia; romania; afghanistan; maldives; vietnam; taiwan; micronesia; united states minor outlying islands; central african republic; nepal; niger; ireland; jamaica
human metapneumovirus	Virus	23	south korea; germany; china; hong kong; italy; canada; united kingdom; united states; thailand; croatia; denmark; brazil; india; japan; australia; spain; cambodia; france; singapore; egypt; south africa; israel; taiwan
human papillomavirus 10	Virus	1	germany
human papillomavirus 16	Virus	26	cyprus; ethiopia; hong kong; united kingdom; canada; united states; china; mexico; portugal; thailand; greece; honduras; paraguay; south africa; india; iran; south korea; argentina; japan; brazil; italy; germany; sweden; zimbabwe; taiwan; costa rica
human papillomavirus 18	Virus	15	china; united kingdom; france; costa rica; hong kong; cyprus; greece; thailand; united states; brazil; mauritius; mexico; india; south africa; taiwan
human papillomavirus 26	Virus	6	china; hong kong; thailand; cyprus; brazil; finland
human papillomavirus 32	Virus	2	thailand; china
human papillomavirus 34	Virus	2	thailand; china
human papillomavirus 49	Virus	1	argentina
human papillomavirus 5	Virus	3	united states; italy; slovenia
human papillomavirus 53	Virus	12	south africa; india; morocco; hong kong; united kingdom; united states; mexico; brazil; portugal; china; thailand; italy
human papillomavirus 54	Virus	1	china
human papillomavirus 6	Virus	11	south africa; united kingdom; china; hong kong; italy; thailand; hungary; slovenia; mexico; brazil; united states
human papillomavirus 61	Virus	7	china; costa rica; italy; brazil; thailand; vietnam; sweden
human papillomavirus 7	Virus	2	china; united states
human papillomavirus 9	Virus	1	italy
human parainfluenza virus 1	Virus	2	india; united states
human parainfluenza virus 2	Virus	3	saudi arabia; united states; france
human parainfluenza virus 3	Virus	6	saudi arabia; china; canada; japan; united states; united kingdom
human parainfluenza virus 4	Virus	4	canada; united states; hong kong; australia
human parechovirus	Virus	16	finland; china; sri lanka; netherlands; japan; canada; italy; south korea; united states; brazil; germany; thailand; united kingdom; spain; france; croatia
human parvovirus b19	Virus	26	kenya; poland; estonia; bulgaria; burkina faso; united kingdom; canada; belgium; germany; china; united states; taiwan; nigeria; ghana; brazil; greece; thailand; paraguay; russia; georgia; serbia; luxembourg; kyrgyzstan; france; netherlands; israel
human picobirnavirus	Virus	6	united states; argentina; hungary; thailand; china; india
human respiratory syncytial virus	Virus	29	kenya; south korea; argentina; china; belgium; japan; canada; united kingdom; united states; venezuela; hong kong; iran; italy; vietnam; colombia; nicaragua; peru; cambodia; latvia; uruguay; turkey; south africa; brazil; el salvador; bolivia; saudi arabia; ecuador; india; singapore
human rhinovirus a	Virus	14	finland; united states; panama; thailand; brazil; japan; malaysia; china; cuba; australia; taiwan; belgium; philippines; south korea
human rhinovirus b	Virus	9	finland; south korea; new zealand; united states; japan; china; panama; thailand; brazil
human rhinovirus c	Virus	16	finland; united kingdom; japan; australia; united states; panama; switzerland; cuba; malaysia; thailand; philippines; hong kong; china; south korea; papua new guinea; brazil
hymenolepis diminuta	Helminth	3	egypt; denmark; japan
hymenolepis nana	Helminth	7	iran; japan; united states; egypt; mexico; brazil; turkey
hyphopichia burtonii	Fungi	1	mexico
ignatzschineria indica	Bacteria	2	canada; india
ilheus virus	Virus	1	brazil
infectious spleen and kidney necrosis virus	Virus	11	china; united states; hong kong; malaysia; japan; indonesia; thailand; singapore; taiwan; south korea; india
influenza a virus	Virus	113	iran; kenya; saudi arabia; egypt; greece; belarus; finland; turkey; hungary; south africa; bangladesh; india; vietnam; turkmenistan; zambia; china; hong kong; south korea; japan; russia; australia; spain; denmark; portugal; tunisia; united kingdom; burkina faso; sweden; austria; belgium; germany; italy; brazil; costa rica; colombia; ecuador; argentina; chile; peru; mexico; northern mariana islands; canada; united states; norway; france; thailand; israel; azerbaijan; pakistan; kuwait; philippines; cambodia; kyrgyzstan; qatar; new zealand; fiji; taiwan; indonesia; lebanon; jordan; sudan; myanmar; nicaragua; czech republic; netherlands; ghana; slovakia; puerto rico; guam; bosnia and herzegovina; bulgaria; paraguay; french guiana; croatia; estonia; nigeria; uganda; uruguay; panama; cuba; slovenia; switzerland; bolivia; malaysia; lithuania; uzbekistan; iraq; el salvador; poland; venezuela; french polynesia; ivory coast; djibouti; kazakhstan; mongolia; singapore; dominican republic; united arab emirates; ukraine; romania; malawi; samoa; ireland; senegal; new caledonia; afghanistan; honduras; mayotte; madagascar; reunion; united states minor outlying islands; solomon islands; maldives
influenza b virus	Virus	49	kenya; egypt; iran; finland; south africa; china; south korea; japan; australia; denmark; spain; brazil; ecuador; argentina; northern mariana islands; united states; oman; philippines; thailand; panama; india; canada; taiwan; hong kong; lebanon; romania; russia; france; norway; ghana; belgium; israel; latvia; papua new guinea; nicaragua; italy; austria; switzerland; malaysia; peru; greece; united kingdom; new zealand; mexico; madagascar; poland; maldives; singapore; solomon islands
influenza c virus	Virus	3	japan; united states; south africa
janibacter anophelis	Bacteria	1	india
japanese encephalitis virus	Virus	17	malaysia; australia; china; taiwan; united states; papua new guinea; vietnam; myanmar; japan; indonesia; thailand; philippines; south korea; laos; india; singapore; maldives
jc polyomavirus	Virus	57	turkey; ethiopia; kenya; macedonia; saudi arabia; central african republic; mauritius; united kingdom; wallis and futuna; guam; china; fiji; south korea; sweden; germany; taiwan; united states; sudan; niger; portugal; micronesia; iran; zambia; vietnam; kuwait; myanmar; vanuatu; new caledonia; japan; finland; philippines; spain; mongolia; sri lanka; malaysia; russia; uzbekistan; kiribati; tonga; france; india; tanzania; indonesia; greece; solomon islands; bulgaria; italy; brazil; morocco; ghana; south africa; australia; canada; papua new guinea; netherlands; mauritania; thailand
kingella kingae	Bacteria	1	france
klebsiella oxytoca	Bacteria	20	iran; india; united kingdom; japan; portugal; denmark; spain; malaysia; united states; ireland; china; france; austria; antarctica; germany; brazil; pakistan; australia; uruguay; netherlands
klebsiella pneumoniae	Bacteria	46	kenya; bulgaria; iran; india; netherlands; germany; new zealand; australia; united kingdom; greece; mexico; colombia; japan; poland; malaysia; portugal; thailand; spain; brazil; iraq; south africa; united states; ireland; china; france; uganda; sweden; austria; denmark; taiwan; gabon; singapore; tunisia; turkey; vietnam; canada; italy; bangladesh; saudi arabia; trinidad and tobago; hong kong; senegal; nigeria; puerto rico; croatia; maldives
kluyvera ascorbata	Bacteria	7	russia; thailand; france; argentina; india; united states; brazil
kluyvera cryocrescens	Bacteria	4	spain; brazil; singapore; china
kluyveromyces marxianus	Fungi	9	ethiopia; spain; netherlands; thailand; china; south africa; morocco; oman; mexico
kocuria polaris	Bacteria	4	india; antarctica; hungary; mali
kyasanur forest disease virus	Virus	4	china; saudi arabia; egypt; slovenia
kytococcus schroeteri	Bacteria	3	india; china; germany
kytococcus sedentarius	Bacteria	3	portugal; croatia; austria
lacazia loboi	Fungi	1	brazil
lactobacillus acidophilus	Bacteria	6	china; india; south korea; germany; sweden; saudi arabia
lactobacillus brevis	Bacteria	12	bulgaria; germany; china; india; south korea; turkey; japan; south africa; argentina; iran; thailand; italy
lactobacillus casei	Bacteria	13	mexico; china; india; south korea; united kingdom; iran; germany; burkina faso; spain; serbia; japan; uganda; sweden
lactobacillus crispatus	Bacteria	5	finland; united kingdom; china; spain; italy
lactobacillus delbrueckii	Bacteria	6	bulgaria; india; brazil; china; south korea; georgia
lactobacillus fermentum	Bacteria	13	estonia; kenya; china; brazil; india; ghana; united states; spain; pakistan; switzerland; thailand; italy; nigeria
lactobacillus gasseri	Bacteria	6	china; italy; japan; sweden; spain; serbia
lactobacillus helveticus	Bacteria	5	china; mexico; india; ghana; armenia
lactobacillus iners	Bacteria	1	spain
lactobacillus jensenii	Bacteria	2	china; spain
lactobacillus johnsonii	Bacteria	2	india; costa rica
lactobacillus mucosae	Bacteria	4	china; italy; spain; denmark
lactobacillus parabuchneri	Bacteria	3	china; germany; italy
lactobacillus paracasei	Bacteria	11	germany; italy; spain; iran; china; south korea; greece; switzerland; united kingdom; india; uganda
lactobacillus plantarum	Bacteria	27	bulgaria; kenya; china; switzerland; india; greece; taiwan; south korea; new zealand; ghana; germany; turkey; italy; nigeria; united states; thailand; japan; egypt; argentina; united kingdom; spain; serbia; france; iran; uganda; mexico; burkina faso
lactobacillus reuteri	Bacteria	8	china; india; ghana; south korea; canada; germany; italy; spain
lactobacillus rhamnosus	Bacteria	11	sweden; mexico; canada; pakistan; finland; india; china; spain; germany; united kingdom; japan
lactobacillus ruminis	Bacteria	1	china
lactobacillus sakei	Bacteria	8	france; germany; italy; norway; japan; south korea; china; taiwan
lactobacillus salivarius	Bacteria	8	bulgaria; china; ghana; spain; turkey; thailand; japan; france
lactobacillus ultunensis	Bacteria	1	italy
lactobacillus vaginalis	Bacteria	1	china
lactococcus garvieae	Bacteria	9	japan; spain; chile; cambodia; taiwan; south korea; iran; china; italy
lactococcus lactis	Bacteria	16	china; india; taiwan; united kingdom; russia; turkey; spain; iran; italy; denmark; japan; uganda; serbia; south korea; chile; finland
lake victoria marburgvirus	Virus	5	uganda; democratic republic of the congo; germany; kenya; angola
laribacter hongkongensis	Bacteria	2	china; hong kong
lassa virus	Virus	4	nigeria; sierra leone; guinea; liberia
leclercia adecarboxylata	Bacteria	5	russia; ecuador; china; malaysia; south korea
lecythophora hoffmannii	Fungi	6	sweden; lithuania; switzerland; germany; united states; united kingdom
lecythophora lignicola	Fungi	1	sweden
lecythophora mutabilis	Fungi	5	japan; lithuania; argentina; germany; united states
legionella anisa	Bacteria	6	japan; greece; czech republic; germany; italy; france
legionella longbeachae	Bacteria	2	japan; australia
legionella pneumophila	Bacteria	21	greece; sweden; italy; germany; united states; canada; singapore; china; spain; tunisia; portugal; antarctica; austria; japan; iceland; thailand; australia; france; russia; united kingdom; taiwan
leishmania aethiopica	Protozoa	2	ethiopia; eritrea
leishmania amazonensis	Protozoa	1	brazil
leishmania braziliensis	Protozoa	7	bolivia; colombia; brazil; argentina; venezuela; panama; guatemala
leishmania chagasi	Protozoa	1	brazil
leishmania donovani	Protozoa	23	saudi arabia; ethiopia; india; china; sudan; lebanon; iran; russia; france; kenya; portugal; bangladesh; italy; brazil; iraq; djibouti; algeria; bhutan; sri lanka; egypt; cyprus; united kingdom; maldives
leishmania guyanensis	Protozoa	4	brazil; austria; colombia; french guiana
leishmania infantum	Protozoa	16	iran; sudan; china; spain; turkey; greece; tunisia; argentina; brazil; georgia; italy; france; malta; uzbekistan; israel; cyprus
leishmania lainsoni	Protozoa	1	bolivia
leishmania major	Protozoa	13	israel; sudan; saudi arabia; turkmenistan; tunisia; iran; kenya; uzbekistan; iraq; morocco; syria; egypt; senegal
leishmania mexicana	Protozoa	6	mexico; belize; panama; brazil; guatemala; united states
leishmania panamensis	Protozoa	3	panama; colombia; ecuador
leishmania peruviana	Protozoa	1	peru
leishmania tropica	Protozoa	11	turkey; tunisia; iran; iraq; sudan; afghanistan; kenya; india; egypt; saudi arabia; morocco
leptosphaeria tompkinsii	Fungi	1	india
leptospira borgpetersenii	Bacteria	7	japan; china; peru; philippines; new caledonia; ecuador; australia
leptospira inadai	Bacteria	1	ecuador
leptospira interrogans	Bacteria	24	turkey; iran; china; denmark; india; thailand; madagascar; south korea; peru; philippines; new caledonia; colombia; united states; belgium; egypt; brazil; japan; indonesia; poland; australia; united kingdom; canada; french polynesia; maldives
leptospira kirschneri	Bacteria	2	peru; iran
leptospira santarosai	Bacteria	1	ecuador
leptospira weilii	Bacteria	1	china
leuconostoc citreum	Bacteria	7	spain; taiwan; south korea; nepal; japan; cuba; china
leuconostoc fallax	Bacteria	3	spain; italy; taiwan
leuconostoc pseudomesenteroides	Bacteria	6	taiwan; south korea; japan; china; costa rica; united states
lewia infectoria	Fungi	9	russia; portugal; turkey; spain; australia; iran; austria; china; united kingdom
lichtheimia corymbifera	Fungi	1	afghanistan
lichtheimia ramosa	Fungi	3	china; belgium; ghana
listeria innocua	Bacteria	5	united states; japan; germany; france; china
listeria ivanovii	Bacteria	2	china; france
listeria monocytogenes	Bacteria	18	china; france; india; greece; united kingdom; united states; iran; belgium; japan; canada; denmark; norway; italy; spain; south africa; taiwan; brazil; costa rica
listeria seeligeri	Bacteria	3	china; france; united states
listeria welshimeri	Bacteria	2	china; france
loa loa	Helminth	1	nigeria
lodderomyces elongisporus	Fungi	1	china
louping ill virus	Virus	1	united kingdom
lymphocytic choriomeningitis virus	Virus	4	united kingdom; france; united states; bulgaria
lysinibacillus sphaericus	Bacteria	16	pakistan; india; china; united kingdom; germany; mexico; malaysia; united states; spain; colombia; finland; japan; argentina; singapore; russia; brazil
macacine herpesvirus 1	Virus	1	united states
machupo virus	Virus	1	bolivia
madrid virus	Virus	1	panama
malassezia furfur	Fungi	10	netherlands; hong kong; france; finland; germany; united states; india; sweden; united kingdom; canada
malassezia globosa	Fungi	5	india; hong kong; germany; canada; united kingdom
malassezia obtusa	Fungi	1	united kingdom
malassezia pachydermatis	Fungi	2	sweden; france
malassezia restricta	Fungi	5	india; united kingdom; germany; canada; lithuania
malassezia slooffiae	Fungi	4	france; canada; south africa; united kingdom
malassezia sympodialis	Fungi	8	india; united kingdom; argentina; united states; spain; sweden; canada; brazil
malikia granosa	Bacteria	1	germany
mammalian orthoreovirus	Virus	7	china; cameroon; united states; canada; south korea; italy; japan
mannheimia haemolytica	Bacteria	6	norway; belgium; germany; australia; united kingdom; canada
mansonella ozzardi	Helminth	6	brazil; argentina; bolivia; haiti; venezuela; trinidad and tobago
marituba virus	Virus	4	brazil; peru; trinidad and tobago; united states
massilia timonae	Bacteria	4	finland; united states; france; russia
mayaro virus	Virus	5	brazil; french guiana; peru; bolivia; trinidad and tobago
measles virus	Virus	106	iran; poland; uganda; democratic republic of the congo; kenya; turkey; central african republic; belarus; botswana; mozambique; albania; romania; india; hong kong; japan; gambia; senegal; denmark; morocco; liberia; germany; angola; united states; united kingdom; bolivia; israel; greece; south africa; thailand; china; russia; gabon; belgium; switzerland; austria; netherlands; panama; canada; taiwan; nepal; libya; mauritania; niger; new zealand; sudan; malawi; kazakhstan; vietnam; tunisia; chile; ghana; lesotho; togo; namibia; indonesia; italy; ireland; mexico; spain; south korea; cambodia; bulgaria; estonia; latvia; azerbaijan; france; norway; uruguay; brazil; ecuador; uzbekistan; benin; malaysia; zimbabwe; iraq; somalia; sierra leone; syria; ivory coast; slovenia; afghanistan; oman; republic of the congo; portugal; rwanda; nigeria; luxembourg; argentina; czech republic; australia; croatia; moldova; kyrgyzstan; hungary; burkina faso; colombia; seychelles; swaziland; ukraine; zambia; cameroon; mayotte; pakistan; equatorial guinea; papua new guinea; guinea-bissau
megasphaera elsdenii	Bacteria	1	japan
mesocestoides lineatus	Helminth	2	germany; slovakia
mesorhizobium loti	Bacteria	8	sweden; netherlands; belgium; united states; japan; ethiopia; china; new zealand
metagonimus yokogawai	Helminth	1	japan
methylobacterium radiotolerans	Bacteria	4	china; taiwan; vietnam; spain
meyerozyma guilliermondii	Fungi	14	india; japan; brazil; mexico; lithuania; taiwan; iran; italy; portugal; united states; thailand; china; france; austria
microbacterium aurum	Bacteria	1	netherlands
microbacterium esteraromaticum	Bacteria	4	mexico; japan; brazil; india
microbacterium flavescens	Bacteria	1	china
microbacterium foliorum	Bacteria	3	china; germany; japan
microbacterium hydrocarbonoxydans	Bacteria	1	india
microbacterium lacticum	Bacteria	1	china
microbacterium oleivorans	Bacteria	2	india; spain
microbacterium oxydans	Bacteria	17	china; india; lithuania; chile; russia; slovakia; hungary; spain; germany; canada; japan; finland; south korea; mexico; czech republic; bangladesh; portugal
microbacterium paraoxydans	Bacteria	8	china; pakistan; france; mexico; russia; malaysia; india; belgium
microbacterium phyllosphaerae	Bacteria	7	china; germany; spain; united kingdom; united states; france; portugal
microbacterium resistens	Bacteria	4	south korea; russia; india; spain
microbacterium schleiferi	Bacteria	1	china
microbacterium testaceum	Bacteria	5	hungary; brazil; india; croatia; bahamas
microbacterium trichothecenolyticum	Bacteria	2	china; italy
micrococcus luteus	Bacteria	22	china; australia; united kingdom; japan; germany; spain; finland; netherlands; portugal; svalbard and jan mayen; brazil; india; bahamas; austria; hungary; saudi arabia; morocco; antarctica; france; malaysia; south korea; united states
microsporum audouinii	Fungi	2	democratic republic of the congo; ivory coast
microsporum ferrugineum	Fungi	1	iran
microsporum gallinae	Fungi	2	japan; iran
mokola virus	Virus	4	central african republic; zimbabwe; cameroon; south africa
molluscum contagiosum virus	Virus	4	united kingdom; netherlands; slovenia; spain
monkeypox virus	Virus	10	liberia; democratic republic of the congo; netherlands; denmark; sierra leone; france; nigeria; gabon; benin; united states
moraxella catarrhalis	Bacteria	4	united states; china; taiwan; united kingdom
moraxella lacunata	Bacteria	2	japan; china
moraxella nonliquefaciens	Bacteria	1	norway
moraxella osloensis	Bacteria	4	germany; austria; united kingdom; china
morganella morganii	Bacteria	10	india; argentina; russia; china; sweden; austria; brazil; kenya; italy; taiwan
mouse mammary tumor virus	Virus	4	australia; mexico; united states; vietnam
mucor circinelloides	Fungi	6	czech republic; saudi arabia; netherlands; japan; spain; china
mucor hiemalis	Fungi	6	switzerland; germany; china; lithuania; saudi arabia; czech republic
mumps virus	Virus	19	india; china; germany; canada; united kingdom; dominican republic; japan; spain; united states; croatia; brazil; lithuania; portugal; belarus; russia; ireland; nigeria; singapore; denmark
murine leukemia virus	Virus	3	china; united states; france
murray valley encephalitis virus	Virus	1	australia
mycobacterium abscessus	Bacteria	6	germany; kuwait; japan; south korea; china; taiwan
mycobacterium arupense	Bacteria	4	mexico; ghana; japan; united states
mycobacterium austroafricanum	Bacteria	2	belgium; france
mycobacterium avium	Bacteria	19	cyprus; germany; mexico; india; czech republic; united kingdom; russia; united states; slovakia; netherlands; new zealand; chile; finland; canada; brazil; australia; japan; taiwan; hong kong
mycobacterium bacteremicum	Bacteria	1	india
mycobacterium bohemicum	Bacteria	1	finland
mycobacterium bolletii	Bacteria	4	france; south korea; brazil; india
mycobacterium bovis	Bacteria	20	brazil; united kingdom; czech republic; netherlands; belgium; japan; tanzania; ethiopia; uganda; mexico; nepal; burundi; somalia; france; guinea-bissau; china; south africa; canada; united states; maldives
mycobacterium canettii	Bacteria	2	france; djibouti
mycobacterium celatum	Bacteria	3	united kingdom; italy; india
mycobacterium chelonae	Bacteria	3	united kingdom; kuwait; united states
mycobacterium chlorophenolicum	Bacteria	2	spain; kuwait
mycobacterium conceptionense	Bacteria	2	united states; france
mycobacterium fortuitum	Bacteria	9	mexico; india; ghana; united states; kuwait; czech republic; germany; nepal; taiwan
mycobacterium genavense	Bacteria	1	japan
mycobacterium gordonae	Bacteria	3	china; kuwait; mexico
mycobacterium haemophilum	Bacteria	1	united states
mycobacterium intracellulare	Bacteria	5	brazil; india; japan; kuwait; spain
mycobacterium kansasii	Bacteria	8	brazil; belgium; kuwait; india; china; japan; united states; taiwan
mycobacterium kumamotonense	Bacteria	1	japan
mycobacterium lentiflavum	Bacteria	1	india
mycobacterium leprae	Bacteria	13	vietnam; south korea; brazil; malawi; india; indonesia; japan; mali; french polynesia; united states; philippines; china; maldives
mycobacterium lepromatosis	Bacteria	2	brazil; singapore
mycobacterium mantenii	Bacteria	1	mexico
mycobacterium marinum	Bacteria	7	taiwan; united states; denmark; japan; israel; united kingdom; germany
mycobacterium mucogenicum	Bacteria	2	united kingdom; taiwan
mycobacterium neoaurum	Bacteria	2	brazil; india
mycobacterium noviomagense	Bacteria	1	netherlands
mycobacterium parascrofulaceum	Bacteria	1	south korea
mycobacterium peregrinum	Bacteria	2	germany; mexico
mycobacterium riyadhense	Bacteria	3	bahrain; france; saudi arabia
mycobacterium scrofulaceum	Bacteria	3	china; brazil; ghana
mycobacterium simiae	Bacteria	4	united states; cuba; india; brazil
mycobacterium smegmatis	Bacteria	2	mexico; united kingdom
mycobacterium terrae	Bacteria	2	brazil; russia
mycobacterium thermoresistibile	Bacteria	1	nepal
mycobacterium tuberculosis	Bacteria	71	india; south africa; sri lanka; pakistan; spain; russia; chad; sweden; mexico; france; turkey; united states; thailand; benin; french polynesia; venezuela; taiwan; china; united kingdom; central african republic; iran; japan; vietnam; brazil; kuwait; tanzania; ethiopia; hungary; myanmar; cambodia; australia; burkina faso; guinea-bissau; germany; peru; canada; czech republic; colombia; poland; romania; bangladesh; cameroon; senegal; portugal; italy; cuba; lebanon; algeria; puerto rico; kenya; malawi; hong kong; singapore; norway; haiti; argentina; sudan; zambia; nigeria; denmark; zimbabwe; madagascar; philippines; morocco; saudi arabia; uganda; new zealand; democratic republic of the congo; united states minor outlying islands; maldives; martinique
mycobacterium ulcerans	Bacteria	9	china; mexico; ghana; democratic republic of the congo; japan; australia; malaysia; french guiana; togo
mycobacterium xenopi	Bacteria	3	united kingdom; netherlands; taiwan
mycoplasma fermentans	Bacteria	2	canada; south korea
mycoplasma genitalium	Bacteria	6	denmark; iran; sweden; japan; united kingdom; australia
mycoplasma hominis	Bacteria	5	germany; iran; denmark; australia; united kingdom
mycoplasma ovis	Bacteria	2	argentina; united states
mycoplasma pneumoniae	Bacteria	8	netherlands; singapore; taiwan; united kingdom; canada; united states; china; hong kong
mycoplasma salivarium	Bacteria	2	iran; united kingdom
myrmecridium schulzeri	Fungi	3	south africa; germany; australia
naegleria fowleri	Protozoa	5	united states; hong kong; france; new zealand; australia
naegleria philippinensis	Protozoa	1	philippines
necator americanus	Helminth	9	guatemala; malaysia; thailand; togo; china; australia; tanzania; south africa; maldives
neisseria bacilliformis	Bacteria	1	united kingdom
neisseria cinerea	Bacteria	1	switzerland
neisseria gonorrhoeae	Bacteria	41	kenya; italy; china; japan; india; uruguay; taiwan; tanzania; pakistan; bangladesh; spain; united states; singapore; papua new guinea; netherlands; norway; argentina; thailand; hong kong; united kingdom; sweden; trinidad and tobago; ethiopia; australia; senegal; zimbabwe; south africa; nigeria; benin; france; rwanda; indonesia; malaysia; peru; canada; central african republic; uganda; gabon; french polynesia; maldives; democratic republic of the congo
neisseria lactamica	Bacteria	5	netherlands; mali; united kingdom; burkina faso; germany
neisseria meningitidis	Bacteria	44	ethiopia; chad; sweden; italy; germany; netherlands; united kingdom; russia; united states; nepal; japan; china; france; finland; thailand; brazil; croatia; india; saudi arabia; south africa; gambia; morocco; algeria; niger; norway; cuba; republic of the congo; chile; ghana; mali; burkina faso; iran; israel; malawi; australia; spain; denmark; singapore; greece; hong kong; new zealand; canada; taiwan; senegal
neisseria shayeganii	Bacteria	2	taiwan; united states
neisseria sicca	Bacteria	1	japan
neocosmospora vasinfecta	Fungi	1	italy
neodeightonia subglobosa	Fungi	1	united kingdom
neosartorya hiratsukae	Fungi	2	czech republic; spain
neoscytalidium dimidiatum	Fungi	10	japan; united kingdom; mali; united states; australia; brazil; china; taiwan; italy; egypt
neurospora crassa	Fungi	3	india; japan; united states
newcastle disease virus	Virus	58	israel; turkey; bulgaria; saudi arabia; tanzania; china; burkina faso; argentina; mexico; antarctica; india; russia; germany; canada; taiwan; nigeria; iran; venezuela; hong kong; italy; dominican republic; japan; czech republic; australia; egypt; peru; colombia; singapore; finland; belize; bangladesh; united states; france; denmark; south africa; brazil; sweden; cameroon; ukraine; indonesia; united arab emirates; iraq; sudan; myanmar; jordan; ireland; portugal; united kingdom; south korea; hungary; belgium; burundi; pakistan; nicaragua; kazakhstan; austria; chile; malaysia
nipah virus	Virus	5	malaysia; cambodia; bangladesh; india; singapore
nocardia amamiensis	Bacteria	1	japan
nocardia asteroides	Bacteria	2	china; spain
nocardia beijingensis	Bacteria	1	costa rica
nocardia brasiliensis	Bacteria	1	south africa
nocardia cyriacigeorgica	Bacteria	4	china; south africa; india; iran
nocardia exalbida	Bacteria	2	south africa; japan
nocardia farcinica	Bacteria	4	south africa; czech republic; japan; india
nocardia nova	Bacteria	2	south africa; japan
nocardia otitidiscaviarum	Bacteria	1	south africa
nocardiopsis dassonvillei	Bacteria	3	china; italy; thailand
norwalk virus	Virus	50	iran; finland; bangladesh; india; hungary; china; hong kong; south korea; japan; russia; australia; united kingdom; belgium; germany; brazil; italy; colombia; venezuela; mexico; united states; canada; madagascar; france; pakistan; sweden; switzerland; ghana; nicaragua; ireland; bulgaria; egypt; denmark; spain; slovenia; thailand; austria; malaysia; iraq; luxembourg; taiwan; netherlands; new zealand; south africa; vietnam; djibouti; dominican republic; argentina; greece; mongolia; norway
ochrobactrum anthropi	Bacteria	13	germany; australia; south korea; italy; france; japan; portugal; united states; china; united kingdom; ireland; austria; belgium
ochrobactrum haematophilum	Bacteria	1	china
ochrobactrum pseudintermedium	Bacteria	2	united states; india
ochrobactrum pseudogrignonense	Bacteria	2	colombia; china
odoribacter splanchnicus	Bacteria	1	denmark
oesophagostomum bifurcum	Helminth	2	ghana; togo
omsk hemorrhagic fever virus	Virus	1	russia
onchocerca dewittei	Helminth	1	japan
onchocerca lupi	Helminth	4	hungary; united states; greece; turkey
onchocerca volvulus	Helminth	16	sudan; brazil; mexico; yemen; italy; burkina faso; mali; ecuador; ethiopia; benin; south sudan; uganda; cameroon; nigeria; guatemala; togo
ophiostoma stenoceras	Fungi	12	japan; poland; netherlands; united states; norway; south africa; sweden; new zealand; uruguay; colombia; indonesia; kenya
opisthorchis felineus	Helminth	1	russia
opisthorchis viverrini	Helminth	4	cambodia; thailand; laos; taiwan
orf virus	Virus	13	brazil; germany; norway; united states; taiwan; india; iran; greece; italy; united arab emirates; new zealand; china; finland
oriboca virus	Virus	2	french guiana; brazil
orientia tsutsugamushi	Bacteria	10	taiwan; japan; thailand; china; laos; south korea; india; united arab emirates; australia; maldives
oropouche virus	Virus	2	brazil; tunisia
ostertagia ostertagi	Helminth	5	japan; belgium; australia; united states; united kingdom
paecilomyces lilacinus	Fungi	14	india; china; brazil; nigeria; kuwait; cambodia; united states; thailand; iraq; japan; spain; sweden; australia; mexico
paecilomyces variotii	Fungi	3	china; brazil; united states
paenibacillus alvei	Bacteria	1	india
pantoea agglomerans	Bacteria	21	mexico; germany; new zealand; russia; china; italy; japan; france; switzerland; spain; brazil; malaysia; india; austria; algeria; israel; south africa; belarus; united states; finland; croatia
pantoea brenneri	Bacteria	1	china
pantoea conspicua	Bacteria	2	china; united states
pantoea eucrina	Bacteria	2	spain; malaysia
parabacteroides distasonis	Bacteria	3	spain; sweden; united states
parabacteroides merdae	Bacteria	1	china
paracoccidioides brasiliensis	Fungi	6	peru; costa rica; japan; brazil; argentina; venezuela
paracoccus marcusii	Bacteria	3	india; poland; antarctica
paracoccus marinus	Bacteria	1	india
paracoccus yeei	Bacteria	2	india; china
paracoccus zeaxanthinifaciens	Bacteria	2	united kingdom; french polynesia
paragonimus heterotremus	Helminth	3	vietnam; thailand; india
paragonimus kellicotti	Helminth	1	united states
paragonimus miyazakii	Helminth	1	japan
paragonimus skrjabini	Helminth	2	india; china
paragonimus westermani	Helminth	9	india; malaysia; taiwan; portugal; philippines; china; japan; thailand; south korea
parainfluenza virus 5	Virus	3	germany; united kingdom; united states
parascaris equorum	Helminth	1	united states
parvimonas micra	Bacteria	1	brazil
pasteurella canis	Bacteria	2	poland; norway
pasteurella dagmatis	Bacteria	2	poland; norway
pasteurella multocida	Bacteria	17	iran; germany; united kingdom; taiwan; south korea; belgium; united states; malaysia; norway; india; china; denmark; ivory coast; vietnam; syria; australia; canada
pasteurella pneumotropica	Bacteria	2	malaysia; china
pediculus humanus	Arthropod	38	rwanda; burundi; zimbabwe; papua new guinea; denmark; netherlands; portugal; panama; ethiopia; japan; kenya; honduras; united kingdom; russia; united states; iran; colombia; france; argentina; laos; nepal; philippines; yemen; cook islands; israel; australia; germany; china; algeria; canada; ecuador; senegal; peru; thailand; new zealand; brazil; tunisia; taiwan
pediococcus acidilactici	Bacteria	8	china; taiwan; germany; italy; turkey; mexico; ghana; iran
pediococcus pentosaceus	Bacteria	9	china; taiwan; south korea; ghana; mexico; italy; thailand; india; nigeria
penicillium biourgeianum	Fungi	2	switzerland; germany
penicillium brevicompactum	Fungi	5	saudi arabia; australia; canada; china; united states
penicillium brocae	Fungi	1	india
penicillium chrysogenum	Fungi	12	saudi arabia; syria; spain; oman; vietnam; united states; egypt; china; germany; antarctica; lithuania; bulgaria
penicillium citreonigrum	Fungi	4	brazil; china; ecuador; lithuania
penicillium citrinum	Fungi	10	india; australia; south korea; czech republic; united states; egypt; china; brazil; japan; mozambique
penicillium griseofulvum	Fungi	3	china; czech republic; bulgaria
penicillium marneffei	Fungi	9	australia; france; taiwan; hong kong; united states; mexico; china; greece; thailand
penicillium purpurogenum	Fungi	1	czech republic
penicillium raistrickii	Fungi	1	china
pentatrichomonas hominis	Protozoa	3	united states; austria; south korea
pepper mild mottle virus	Virus	12	china; spain; egypt; japan; italy; south korea; brazil; france; hungary; india; israel; germany
phaeoacremonium venezuelense	Fungi	1	brazil
phanerochaete sordida	Fungi	6	japan; sweden; brazil; taiwan; australia; spain
phialemonium curvatum	Fungi	1	united states
phialemonium obovatum	Fungi	2	china; united states
phialophora verrucosa	Fungi	2	australia; japan
photobacterium damselae	Bacteria	9	mexico; malaysia; greece; spain; china; japan; taiwan; united states; italy
pichia kudriavzevii	Fungi	15	india; spain; brazil; ghana; myanmar; russia; portugal; thailand; china; argentina; indonesia; taiwan; nepal; ethiopia; united kingdom
piedraia hortae	Fungi	2	french guiana; brazil
pigmentiphaga daeguensis	Bacteria	1	new zealand
plasmodium falciparum	Protozoa	86	zimbabwe; iran; china; malawi; madagascar; comoros; pakistan; japan; liberia; gambia; brazil; angola; india; burundi; vietnam; gabon; malaysia; niger; philippines; papua new guinea; togo; ghana; myanmar; indonesia; colombia; vanuatu; democratic republic of the congo; kenya; equatorial guinea; france; netherlands; cambodia; bangladesh; denmark; suriname; sri lanka; french guiana; el salvador; senegal; thailand; cameroon; benin; zambia; sierra leone; sao tome and principe; venezuela; tanzania; chad; uganda; haiti; solomon islands; east timor; nigeria; ivory coast; peru; central african republic; sudan; cape verde; ecuador; guinea; burkina faso; guyana; south africa; honduras; laos; mali; united kingdom; puerto rico; canada; italy; republic of the congo; mozambique; maldives; taiwan; spain; australia; switzerland; united states; ethiopia; germany; guatemala; singapore; guinea-bissau; panama; new caledonia; mayotte
plasmodium knowlesi	Protozoa	5	malaysia; indonesia; kenya; japan; thailand
plasmodium malariae	Protozoa	9	uganda; japan; indonesia; french guiana; cameroon; ivory coast; myanmar; united kingdom; maldives
plasmodium ovale	Protozoa	13	cameroon; benin; gabon; nigeria; myanmar; ghana; vietnam; indonesia; thailand; sao tome and principe; ivory coast; peru; maldives
plasmodium vivax	Protozoa	51	iran; sudan; china; madagascar; liberia; guinea; colombia; india; turkey; south korea; philippines; mauritania; indonesia; myanmar; honduras; bangladesh; azerbaijan; sri lanka; malaysia; thailand; el salvador; ecuador; pakistan; venezuela; afghanistan; uganda; north korea; vietnam; brazil; italy; vanuatu; nicaragua; east timor; mozambique; malawi; papua new guinea; mexico; greece; solomon islands; united kingdom; australia; united states; russia; peru; singapore; ethiopia; trinidad and tobago; guatemala; panama; france; maldives
plesiomonas shigelloides	Bacteria	2	mexico; bangladesh
pneumocystis carinii	Fungi	13	spain; france; united states; iran; germany; united kingdom; taiwan; hong kong; singapore; haiti; india; puerto rico; canada
pneumocystis jirovecii	Fungi	7	india; thailand; south africa; germany; spain; uganda; united kingdom
porcine enterovirus b	Virus	4	taiwan; italy; china; united kingdom
porcine type-c oncovirus	Virus	6	china; canada; italy; germany; united kingdom; south korea
porphyromonas asaccharolytica	Bacteria	1	united states
porphyromonas gingivalis	Bacteria	2	united kingdom; united states
powassan virus	Virus	2	canada; united states
prevotella buccae	Bacteria	2	united kingdom; sweden
prevotella dentalis	Bacteria	1	japan
prevotella loescheii	Bacteria	1	united kingdom
prevotella maculosa	Bacteria	1	united states
prevotella melaninogenica	Bacteria	1	united kingdom
prevotella micans	Bacteria	1	china
prevotella oris	Bacteria	1	united kingdom
prevotella ruminicola	Bacteria	2	united kingdom; japan
prevotella veroralis	Bacteria	1	united kingdom
primate t-lymphotropic virus 1	Virus	46	central african republic; china; spain; argentina; gabon; india; canada; portugal; chile; equatorial guinea; vanuatu; russia; guadeloupe; suriname; south africa; united states; brazil; guyana; sweden; ivory coast; iran; bolivia; germany; japan; jamaica; peru; mozambique; colombia; martinique; cameroon; french guiana; egypt; nigeria; indonesia; guinea-bissau; taiwan; united kingdom; france; solomon islands; trinidad and tobago; democratic republic of the congo; maldives; haiti; french polynesia; australia; panama
primate t-lymphotropic virus 2	Virus	14	spain; argentina; venezuela; united states; ireland; italy; brazil; cameroon; french guiana; portugal; panama; mexico; united kingdom; nigeria
primate t-lymphotropic virus 3	Virus	2	cameroon; ethiopia
propionibacterium acnes	Bacteria	9	brazil; japan; egypt; united kingdom; sweden; austria; spain; germany; india
proteus mirabilis	Bacteria	16	hungary; pakistan; japan; nigeria; united kingdom; canada; italy; poland; tunisia; china; hong kong; austria; india; france; united states; taiwan
proteus vulgaris	Bacteria	4	india; germany; italy; china
prototheca wickerhamii	Green Algae	1	poland
providencia alcalifaciens	Bacteria	3	india; thailand; france
providencia rettgeri	Bacteria	10	india; nigeria; bangladesh; italy; brazil; south africa; china; antarctica; france; venezuela
providencia stuartii	Bacteria	3	hungary; italy; china
pseudallescheria angusta	Fungi	2	united states; argentina
pseudallescheria boydii	Fungi	14	china; spain; japan; switzerland; germany; united states; united kingdom; france; democratic republic of the congo; brazil; argentina; ivory coast; czech republic; ukraine
pseudallescheria ellipsoidea	Fungi	3	tajikistan; united states; spain
pseudallescheria minutispora	Fungi	4	belgium; germany; united states; spain
pseudocowpox virus	Virus	5	finland; norway; bangladesh; india; italy
pseudomonas aeruginosa	Bacteria	53	iran; pakistan; romania; spain; france; germany; italy; egypt; lithuania; libya; belgium; south korea; canada; united states; russia; greece; kuwait; japan; china; poland; czech republic; nigeria; brazil; thailand; morocco; united kingdom; costa rica; malaysia; croatia; india; tunisia; south africa; austria; australia; israel; afghanistan; venezuela; switzerland; puerto rico; singapore; argentina; vietnam; taiwan; hong kong; mexico; saudi arabia; turkey; senegal; trinidad and tobago; panama; kenya; denmark; maldives
pseudomonas alcaligenes	Bacteria	7	china; hong kong; united states; india; bahamas; mexico; italy
pseudomonas anguilliseptica	Bacteria	6	israel; spain; portugal; hungary; japan; mexico
pseudomonas fluorescens	Bacteria	31	iran; pakistan; spain; denmark; france; argentina; united states; germany; mexico; belgium; canada; russia; brazil; china; japan; slovakia; united kingdom; new zealand; india; svalbard and jan mayen; ireland; kyrgyzstan; antarctica; south korea; taiwan; netherlands; italy; czech republic; hungary; austria; belarus
pseudomonas meridiana	Bacteria	1	antarctica
pseudomonas monteilii	Bacteria	6	india; china; belgium; mexico; italy; france
pseudomonas mosselii	Bacteria	6	china; france; mexico; brazil; india; canada
pseudomonas oryzihabitans	Bacteria	4	japan; malaysia; india; kenya
pseudomonas otitidis	Bacteria	4	china; india; united states; south korea
pseudomonas pseudoalcaligenes	Bacteria	9	germany; mexico; italy; egypt; china; bahamas; india; portugal; venezuela
pseudomonas putida	Bacteria	39	iran; belarus; spain; netherlands; france; argentina; germany; mexico; italy; egypt; vietnam; south korea; bolivia; canada; united states; russia; china; brazil; japan; slovakia; grenada; switzerland; united kingdom; croatia; india; taiwan; tunisia; austria; antarctica; hungary; greece; cuba; pakistan; belgium; singapore; ukraine; malaysia; uruguay; venezuela
pseudomonas stutzeri	Bacteria	23	iran; spain; germany; egypt; fiji; belgium; russia; united states; japan; china; thailand; united kingdom; india; croatia; algeria; greece; israel; portugal; colombia; italy; taiwan; hungary; denmark
pseudomonas synxantha	Bacteria	2	israel; spain
pseudoterranova decipiens	Helminth	5	japan; germany; antarctica; canada; united states
psychrobacter cibarius	Bacteria	1	china
psychrobacter faecalis	Bacteria	2	germany; finland
psychrobacter nivimaris	Bacteria	2	india; antarctica
psychrobacter pulmonis	Bacteria	2	china; spain
psychrobacter sanguinis	Bacteria	1	united states
pthirus pubis	Arthropod	3	united states; france; australia
puumala virus	Virus	10	denmark; russia; belgium; austria; germany; china; finland; sweden; slovakia; croatia
pythium aphanidermatum	Water Mould	10	united states; united kingdom; taiwan; france; japan; south africa; egypt; south korea; denmark; mexico
pythium insidiosum	Water Mould	9	japan; united states; australia; thailand; india; haiti; costa rica; brazil; papua new guinea
rabies virus	Virus	83	tanzania; israel; ethiopia; saudi arabia; uganda; central african republic; belarus; estonia; kenya; macedonia; india; romania; burkina faso; morocco; chad; cuba; namibia; argentina; mexico; burundi; china; russia; algeria; oman; netherlands; germany; thailand; norway; canada; nepal; nigeria; united states; sudan; lebanon; zambia; united kingdom; chile; botswana; australia; ghana; egypt; democratic republic of the congo; madagascar; finland; japan; peru; poland; equatorial guinea; spain; philippines; south korea; mongolia; bangladesh; bosnia and herzegovina; sri lanka; south africa; croatia; brazil; benin; el salvador; pakistan; ukraine; ivory coast; georgia; serbia; afghanistan; puerto rico; hungary; vietnam; czech republic; iran; cambodia; jordan; cameroon; indonesia; france; latvia; colombia; turkey; greenland; zimbabwe; french guiana; maldives
ralstonia pickettii	Bacteria	8	germany; australia; senegal; japan; china; india; france; united states
rhinocladiella aquaspersa	Fungi	1	japan
rhinocladiella mackenziei	Fungi	3	saudi arabia; israel; united arab emirates
rhinosporidium seeberi	Others	1	india
rhipicephalus bursa	Arthropod	5	spain; portugal; italy; pakistan; turkey
rhipicephalus sanguineus	Arthropod	15	south africa; argentina; france; chile; united states; paraguay; china; spain; thailand; italy; uzbekistan; brazil; portugal; uruguay; colombia
rhipicephalus turanicus	Arthropod	7	israel; south africa; france; italy; zimbabwe; spain; zambia
rhizobium cellulosilyticum	Bacteria	2	spain; belgium
rhizomucor pusillus	Fungi	4	poland; denmark; australia; ukraine
rhizopus microsporus	Fungi	4	india; spain; australia; united states
rhizopus oryzae	Fungi	5	spain; united states; oman; south korea; saudi arabia
rhizopus stolonifer	Fungi	1	saudi arabia
rhodobacter capsulatus	Bacteria	1	india
rhodococcus equi	Bacteria	10	japan; lithuania; united kingdom; italy; united states; india; spain; austria; germany; canada
rhodococcus rhodochrous	Bacteria	5	hungary; china; vietnam; japan; austria
rhodotorula minuta	Fungi	3	taiwan; japan; china
rhodotorula mucilaginosa	Fungi	18	japan; spain; taiwan; turkey; united kingdom; russia; iran; portugal; italy; china; antarctica; argentina; brazil; germany; belgium; india; latvia; mexico
rickettsia africae	Bacteria	4	egypt; united states; china; ethiopia
rickettsia akari	Bacteria	2	united states; thailand
rickettsia australis	Bacteria	1	australia
rickettsia conorii	Bacteria	5	italy; portugal; algeria; brazil; spain
rickettsia felis	Bacteria	7	australia; france; chile; costa rica; united states; mexico; south korea
rickettsia japonica	Bacteria	1	japan
rickettsia massiliae	Bacteria	8	united states; portugal; cyprus; italy; spain; israel; argentina; china
rickettsia monacensis	Bacteria	3	romania; italy; serbia
rickettsia prowazekii	Bacteria	3	burundi; rwanda; united states
rickettsia rickettsii	Bacteria	5	united states; mexico; brazil; thailand; panama
rickettsia sibirica	Bacteria	1	russia
rickettsia slovaca	Bacteria	5	france; spain; italy; germany; portugal
rickettsia typhi	Bacteria	8	united states; mexico; china; georgia; egypt; thailand; south korea; greece
rift valley fever virus	Virus	19	kenya; saudi arabia; uganda; central african republic; zimbabwe; burkina faso; chad; guinea; brazil; angola; zambia; egypt; madagascar; south africa; senegal; namibia; mauritania; tanzania; maldives
rio mamore virus	Virus	3	brazil; peru; bolivia
roseburia intestinalis	Bacteria	2	india; france
ross river virus	Virus	6	kenya; china; australia; taiwan; japan; fiji
rotavirus a	Virus	54	kenya; israel; zimbabwe; ethiopia; south africa; india; china; malawi; japan; cameroon; denmark; spain; australia; brazil; ireland; argentina; germany; belgium; turkey; ecuador; nigeria; united states; taiwan; thailand; united kingdom; guinea-bissau; ghana; vietnam; italy; myanmar; finland; democratic republic of the congo; hungary; malaysia; south korea; russia; bangladesh; paraguay; cuba; nepal; libya; mexico; france; ivory coast; morocco; new zealand; slovenia; pakistan; egypt; saudi arabia; iran; philippines; hong kong; canada
rotavirus b	Virus	4	china; myanmar; bangladesh; india
rotavirus c	Virus	15	turkey; venezuela; australia; china; united states; united kingdom; japan; brazil; colombia; south korea; spain; bangladesh; russia; india; thailand
rothia aeria	Bacteria	1	united states
rothia dentocariosa	Bacteria	1	portugal
rothia mucilaginosa	Bacteria	3	united kingdom; spain; netherlands
rubella virus	Virus	29	israel; ethiopia; belarus; united kingdom; russia; germany; china; united states; argentina; hong kong; myanmar; japan; italy; greece; finland; spain; mongolia; south africa; india; vietnam; brazil; bosnia and herzegovina; canada; taiwan; thailand; uganda; turkey; australia; france
ruminococcus gnavus	Bacteria	2	sweden; france
saccharomyces cerevisiae	Fungi	39	myanmar; india; ivory coast; japan; brazil; namibia; greece; philippines; taiwan; united kingdom; iran; italy; france; netherlands; portugal; united states; china; argentina; south africa; vietnam; sweden; indonesia; cambodia; belgium; mexico; spain; new zealand; thailand; russia; ghana; burundi; australia; canada; singapore; maldives; germany; united states minor outlying islands; hong kong; french polynesia
saksenaea erythrospora	Fungi	1	australia
salmonella enterica	Bacteria	47	iran; turkey; india; china; albania; bangladesh; vietnam; senegal; spain; japan; brazil; argentina; mexico; germany; portugal; united kingdom; saudi arabia; russia; italy; tunisia; malawi; malaysia; colombia; united states; ireland; pakistan; austria; egypt; singapore; south korea; thailand; chile; canada; south africa; finland; taiwan; hong kong; nepal; greece; kenya; australia; denmark; nigeria; maldives; philippines; indonesia; peru
sandfly fever naples virus	Virus	10	tunisia; india; italy; cyprus; spain; france; iran; croatia; algeria; egypt
sapporo virus	Virus	28	bangladesh; india; china; hungary; hong kong; south korea; japan; denmark; italy; brazil; austria; venezuela; argentina; mexico; australia; france; pakistan; netherlands; canada; russia; germany; mongolia; thailand; spain; united states; sweden; united kingdom; czech republic
sarcocystis hominis	Protozoa	2	china; spain
sarcocystis suihominis	Protozoa	2	china; spain
sarcoptes scabiei	Arthropod	5	panama; australia; china; united states; tanzania
scedosporium apiospermum	Fungi	11	belgium; united states; brazil; argentina; france; netherlands; spain; oman; china; japan; germany
scedosporium aurantiacum	Fungi	5	australia; germany; united states; france; spain
scedosporium dehoogii	Fungi	3	belgium; netherlands; spain
scedosporium prolificans	Fungi	2	united states; australia
schistosoma bovis	Helminth	3	uganda; senegal; tanzania
schistosoma haematobium	Helminth	16	mali; kenya; senegal; cameroon; tanzania; egypt; sudan; mauritius; nigeria; zambia; ghana; togo; south africa; niger; united kingdom; maldives
schistosoma intercalatum	Helminth	2	democratic republic of the congo; sao tome and principe
schistosoma japonicum	Helminth	5	china; japan; philippines; indonesia; taiwan
schistosoma malayensis	Helminth	1	malaysia
schistosoma mansoni	Helminth	26	uganda; liberia; brazil; oman; nigeria; mali; ghana; kenya; france; senegal; zambia; tanzania; guadeloupe; puerto rico; madagascar; egypt; cameroon; togo; south africa; sudan; burundi; venezuela; argentina; maldives; martinique; democratic republic of the congo
schistosoma mattheei	Helminth	1	zambia
schistosoma mekongi	Helminth	2	laos; cambodia
schistosoma spindale	Helminth	2	sri lanka; thailand
schizophyllum commune	Fungi	41	cyprus; india; australia; japan; brazil; chile; lithuania; ghana; taiwan; nigeria; united kingdom; jordan; russia; dominican republic; france; kenya; panama; puerto rico; belize; united states; china; ecuador; indonesia; guyana; jamaica; new zealand; austria; colombia; costa rica; argentina; sweden; papua new guinea; bahamas; south africa; thailand; czech republic; germany; malaysia; portugal; netherlands; morocco
scolecobasidium humicola	Fungi	2	canada; japan
scopulariopsis brevicaulis	Fungi	1	australia
scytalidium hyalinum	Fungi	2	china; brazil
selenomonas infelix	Bacteria	1	united kingdom
semliki forest virus	Virus	3	uganda; finland; united states
seoul virus	Virus	12	china; taiwan; vietnam; singapore; south korea; united kingdom; indonesia; france; north korea; laos; cambodia; united states
serratia liquefaciens	Bacteria	3	malaysia; china; russia
serratia marcescens	Bacteria	19	turkey; iran; india; pakistan; nigeria; japan; united kingdom; russia; philippines; brazil; united states; china; france; tunisia; south korea; venezuela; austria; taiwan; canada
serratia proteamaculans	Bacteria	4	spain; united kingdom; germany; canada
setosphaeria rostrata	Fungi	4	oman; australia; united states; china
severe acute respiratory syndrome-related coronavirus	Virus	10	china; canada; costa rica; hong kong; russia; united states; italy; taiwan; singapore; vietnam
shewanella algae	Bacteria	3	colombia; china; india
shigella boydii	Bacteria	5	united states; china; brazil; portugal; united kingdom
shigella dysenteriae	Bacteria	13	iran; india; germany; bangladesh; ireland; china; nepal; georgia; guatemala; senegal; south africa; maldives; democratic republic of the congo
shigella flexneri	Bacteria	15	bangladesh; india; china; egypt; united states; united kingdom; australia; brazil; iran; russia; japan; taiwan; hong kong; nigeria; senegal
shigella sonnei	Bacteria	14	india; japan; thailand; united states; united kingdom; malaysia; haiti; china; iran; italy; turkey; russia; hong kong; taiwan
simian foamy virus	Virus	10	china; gabon; italy; indonesia; cameroon; united states; india; united kingdom; kenya; ivory coast
simian virus 40	Virus	4	united states; italy; china; taiwan
sindbis virus	Virus	8	cameroon; china; russia; uruguay; finland; australia; azerbaijan; sweden
sin nombre virus	Virus	1	united states
sinorhizobium medicae	Bacteria	10	united states; belgium; spain; croatia; france; tunisia; syria; china; brazil; egypt
sphingomonas melonis	Bacteria	4	china; united states; united kingdom; japan
sphingomonas paucimobilis	Bacteria	2	finland; greece
sphingomonas rhizogenes	Bacteria	1	japan
spirocerca lupi	Helminth	3	israel; south africa; iran
spirometra erinaceieuropaei	Helminth	5	china; japan; australia; singapore; thailand
sporopachydermia lactativora	Fungi	2	antarctica; thailand
sporothrix albicans	Fungi	3	germany; china; reunion
sporothrix brasiliensis	Fungi	2	brazil; italy
sporothrix mexicana	Fungi	3	poland; brazil; germany
sporothrix schenckii	Fungi	18	south africa; china; brazil; france; netherlands; venezuela; united states; peru; colombia; italy; mexico; japan; australia; bolivia; spain; argentina; costa rica; guatemala
staphylococcus aureus	Bacteria	72	sudan; switzerland; china; greece; bangladesh; south korea; belgium; taiwan; gabon; germany; united kingdom; australia; japan; russia; malaysia; iran; colombia; italy; netherlands; ireland; portugal; denmark; united states; mexico; thailand; norway; india; egypt; brazil; south africa; poland; france; georgia; sweden; hong kong; zimbabwe; myanmar; new zealand; malta; iceland; spain; ivory coast; nigeria; slovenia; chile; singapore; nepal; argentina; turkey; saudi arabia; ethiopia; burkina faso; canada; kenya; pakistan; panama; romania; philippines; trinidad and tobago; tanzania; austria; venezuela; puerto rico; senegal; tunisia; madagascar; togo; united states minor outlying islands; fiji; maldives; french polynesia; samoa
staphylococcus capitis	Bacteria	4	denmark; germany; china; india
staphylococcus caprae	Bacteria	3	india; france; germany
staphylococcus cohnii	Bacteria	5	india; china; spain; portugal; france
staphylococcus epidermidis	Bacteria	29	kenya; switzerland; china; south korea; united states; australia; united kingdom; japan; germany; mexico; portugal; netherlands; denmark; croatia; india; cambodia; austria; israel; italy; brazil; spain; poland; turkey; tunisia; romania; malaysia; saudi arabia; taiwan; canada
staphylococcus haemolyticus	Bacteria	16	china; turkey; spain; denmark; france; bahamas; sweden; antarctica; israel; netherlands; norway; india; switzerland; hungary; bangladesh; germany
staphylococcus hominis	Bacteria	12	united states; united kingdom; malaysia; nigeria; germany; spain; portugal; netherlands; india; china; australia; tunisia
staphylococcus intermedius	Bacteria	2	germany; turkey
staphylococcus lentus	Bacteria	5	poland; china; germany; switzerland; hungary
staphylococcus lugdunensis	Bacteria	4	japan; greece; hong kong; singapore
staphylococcus pasteuri	Bacteria	12	israel; poland; malaysia; portugal; united kingdom; mexico; norway; india; china; bahamas; brazil; germany
staphylococcus pettenkoferi	Bacteria	1	china
staphylococcus pseudintermedius	Bacteria	9	hong kong; spain; argentina; germany; united states; norway; switzerland; israel; netherlands
staphylococcus saprophyticus	Bacteria	9	south africa; china; finland; india; japan; france; thailand; italy; poland
staphylococcus sciuri	Bacteria	14	bangladesh; china; south korea; united kingdom; germany; nigeria; india; france; antarctica; serbia; finland; morocco; brazil; denmark
staphylococcus succinus	Bacteria	3	switzerland; south korea; india
staphylococcus warneri	Bacteria	8	hungary; germany; iran; antarctica; morocco; israel; romania; norway
stenella araguata	Fungi	1	venezuela
stenotrophomonas maltophilia	Bacteria	30	bulgaria; israel; china; morocco; germany; united kingdom; mexico; malaysia; czech republic; taiwan; portugal; chile; pakistan; colombia; italy; slovakia; south korea; argentina; india; spain; brazil; japan; russia; iran; denmark; tunisia; united states; hungary; bahamas; greece
st. louis encephalitis virus	Virus	4	argentina; united states; brazil; canada
streptobacillus moniliformis	Bacteria	1	japan
streptococcus agalactiae	Bacteria	20	china; taiwan; russia; japan; australia; iran; thailand; brazil; india; sweden; angola; united states; zimbabwe; italy; canada; singapore; hong kong; spain; united kingdom; trinidad and tobago
streptococcus anginosus	Bacteria	3	united kingdom; spain; thailand
streptococcus canis	Bacteria	2	united states; australia
streptococcus constellatus	Bacteria	2	united kingdom; thailand
streptococcus dysgalactiae	Bacteria	14	australia; portugal; united kingdom; iran; united states; japan; sweden; thailand; switzerland; brazil; india; china; south korea; canada
streptococcus equi	Bacteria	5	china; united kingdom; brazil; australia; germany
streptococcus equinus	Bacteria	4	france; china; spain; united states
streptococcus gordonii	Bacteria	2	united kingdom; spain
streptococcus iniae	Bacteria	5	japan; thailand; south korea; iran; china
streptococcus intermedius	Bacteria	1	united kingdom
streptococcus milleri	Bacteria	1	united kingdom
streptococcus mitis	Bacteria	6	spain; argentina; sweden; united kingdom; india; germany
streptococcus mutans	Bacteria	7	united states; united kingdom; thailand; uganda; sweden; iceland; canada
streptococcus oralis	Bacteria	2	united kingdom; spain
streptococcus parasanguinis	Bacteria	2	spain; united kingdom
streptococcus pasteurianus	Bacteria	2	united states; japan
streptococcus pneumoniae	Bacteria	57	kenya; hungary; iceland; france; fiji; united states; united kingdom; japan; papua new guinea; germany; spain; poland; turkey; new caledonia; italy; cyprus; finland; netherlands; egypt; india; sweden; austria; australia; south africa; slovakia; norway; croatia; china; brazil; uruguay; taiwan; bulgaria; south korea; philippines; russia; nigeria; switzerland; chile; malawi; saudi arabia; bangladesh; argentina; hong kong; greece; thailand; new zealand; canada; uganda; central african republic; nepal; singapore; mexico; senegal; portugal; denmark; cameroon; maldives
streptococcus pseudopneumoniae	Bacteria	1	india
streptococcus pyogenes	Bacteria	34	gambia; brazil; taiwan; new zealand; india; united states; nepal; united kingdom; australia; malaysia; italy; japan; sweden; spain; ethiopia; saudi arabia; thailand; germany; austria; china; finland; egypt; papua new guinea; russia; norway; argentina; canada; trinidad and tobago; pakistan; fiji; hong kong; chile; mexico; french polynesia
streptococcus salivarius	Bacteria	2	united kingdom; spain
streptococcus sanguinis	Bacteria	3	united kingdom; czech republic; sweden
streptococcus sobrinus	Bacteria	4	denmark; uganda; united kingdom; japan
streptococcus suis	Bacteria	11	china; canada; united kingdom; russia; cuba; denmark; belgium; japan; finland; netherlands; hong kong
streptococcus uberis	Bacteria	6	france; united states; australia; iran; denmark; united kingdom
streptomyces somaliensis	Bacteria	1	south korea
strongyloides fuelleborni	Helminth	4	tanzania; japan; gabon; italy
strongyloides stercoralis	Helminth	8	iran; japan; united states; tanzania; taiwan; brazil; australia; puerto rico
sudan ebolavirus	Virus	2	uganda; south sudan
suid herpesvirus 1	Virus	12	china; brazil; belgium; sweden; united states; taiwan; ireland; hungary; argentina; france; south korea; japan
sutterella wadsworthensis	Bacteria	2	sweden; united kingdom
taenia asiatica	Helminth	7	china; indonesia; thailand; taiwan; japan; south korea; mexico
taenia crassiceps	Helminth	3	germany; united states; canada
taenia multiceps	Helminth	4	china; united kingdom; italy; turkey
taenia saginata	Helminth	16	china; japan; australia; brazil; taiwan; nepal; kenya; france; cambodia; thailand; ecuador; spain; indonesia; ethiopia; belgium; vietnam
taenia serialis	Helminth	4	kenya; canada; australia; united states
taenia solium	Helminth	22	madagascar; china; brazil; colombia; vietnam; mexico; nepal; peru; indonesia; cape verde; thailand; cameroon; ecuador; tanzania; haiti; australia; venezuela; india; philippines; united states; guatemala; maldives
taenia taeniaeformis	Helminth	6	australia; germany; china; japan; slovakia; india
talaromyces eburneus	Fungi	2	uganda; united kingdom
talaromyces indigoticus	Fungi	1	panama
tannerella forsythia	Bacteria	1	united states
tatlockia micdadei	Bacteria	1	italy
tatumella ptyseos	Bacteria	1	china
teladorsagia circumcincta	Helminth	6	iran; france; new zealand; united kingdom; cyprus; united states
ternidens deminutus	Helminth	1	ghana
thelazia callipaeda	Helminth	4	china; japan; colombia; italy
thermoascus crustaceus	Fungi	1	china
tick-borne encephalitis virus	Virus	19	estonia; uganda; switzerland; russia; germany; china; czech republic; japan; mongolia; slovenia; italy; latvia; lithuania; south korea; belarus; kyrgyzstan; ukraine; finland; sweden
torque teno mini virus 8	Virus	1	france
torque teno virus 10	Virus	2	united states; japan
torque teno virus 9	Virus	1	united states
toxascaris leonina	Helminth	2	australia; united kingdom
toxocara canis	Helminth	8	china; australia; japan; iran; united kingdom; argentina; poland; brazil
toxocara cati	Helminth	4	iran; japan; australia; united states
toxoplasma gondii	Protozoa	34	uganda; iran; china; japan; germany; united states; canada; indonesia; france; netherlands; french guiana; thailand; brazil; poland; denmark; portugal; india; saudi arabia; taiwan; australia; sweden; italy; trinidad and tobago; argentina; chile; mexico; turkey; singapore; spain; haiti; panama; united kingdom; maldives; french polynesia
trachipleistophora hominis	Fungi	1	australia
treponema pallidum	Bacteria	12	republic of the congo; tanzania; canada; mozambique; germany; thailand; united kingdom; bangladesh; ethiopia; mexico; united states; maldives
treponema putidum	Bacteria	1	switzerland
treponema vincentii	Bacteria	1	united kingdom
trichinella britovi	Helminth	5	japan; france; spain; iran; italy
trichinella nativa	Helminth	2	japan; norway
trichinella nelsoni	Helminth	1	kenya
trichinella papuae	Helminth	1	papua new guinea
trichinella pseudospiralis	Helminth	4	australia; russia; united states; italy
trichinella spiralis	Helminth	11	bulgaria; poland; egypt; thailand; russia; finland; china; romania; spain; united states; south korea
trichobilharzia ocellata	Helminth	1	germany
trichoderma longibrachiatum	Fungi	17	zimbabwe; saudi arabia; ethiopia; india; germany; mexico; vietnam; south korea; canada; united states; colombia; slovakia; china; japan; iran; argentina; brazil
trichomonas vaginalis	Protozoa	15	iran; france; india; china; democratic republic of the congo; south africa; nigeria; bangladesh; australia; united kingdom; kenya; united states; poland; uganda; maldives
trichophyton equinum	Fungi	1	australia
trichophyton mentagrophytes	Fungi	3	oman; china; italy
trichophyton rubrum	Fungi	7	belgium; iran; japan; india; australia; italy; brazil
trichophyton schoenleinii	Fungi	3	iran; belgium; australia
trichophyton soudanense	Fungi	3	senegal; oman; belgium
trichophyton tonsurans	Fungi	4	japan; australia; iran; united kingdom
trichophyton verrucosum	Fungi	1	japan
trichophyton violaceum	Fungi	5	iran; japan; afghanistan; belgium; tunisia
trichosporon asahii	Fungi	8	china; india; indonesia; thailand; australia; brazil; japan; taiwan
trichosporon coremiiforme	Fungi	2	china; turkey
trichosporon cutaneum	Fungi	2	portugal; china
trichosporon dermatis	Fungi	2	china; united states
trichosporon inkin	Fungi	2	china; portugal
trichosporon mucoides	Fungi	5	portugal; thailand; taiwan; germany; austria
trichostrongylus axei	Helminth	4	russia; united kingdom; australia; united states
trichostrongylus colubriformis	Helminth	6	china; russia; guadeloupe; laos; iran; australia
trichuris suis	Helminth	2	china; spain
trichuris trichiura	Helminth	18	china; japan; jamaica; bangladesh; nigeria; brazil; panama; south africa; turkey; nepal; tanzania; taiwan; malaysia; uganda; thailand; venezuela; guatemala; maldives
tritrichomonas foetus	Protozoa	2	united states; south korea
tropheryma whipplei	Bacteria	1	spain
trypanosoma brucei	Protozoa	13	uganda; cameroon; ivory coast; south sudan; nigeria; zambia; democratic republic of the congo; kenya; tanzania; ethiopia; united kingdom; republic of the congo; united states minor outlying islands
trypanosoma cruzi	Protozoa	17	venezuela; argentina; chile; bolivia; peru; colombia; brazil; china; panama; mexico; united states; paraguay; trinidad and tobago; ecuador; el salvador; spain; guatemala
trypanosoma rangeli	Protozoa	7	sudan; honduras; brazil; el salvador; colombia; venezuela; panama
tsukamurella tyrosinosolvens	Bacteria	5	india; china; iran; japan; south korea
tunga penetrans	Arthropod	8	burundi; brazil; togo; madagascar; ecuador; kenya; democratic republic of the congo; taiwan
uncinaria stenocephala	Helminth	2	united states; australia
ureaplasma parvum	Bacteria	1	austria
ureaplasma urealyticum	Bacteria	2	canada; united kingdom
usutu virus	Virus	5	hungary; italy; south africa; austria; germany
vaccinia virus	Virus	11	turkey; saudi arabia; india; brazil; canada; netherlands; united kingdom; denmark; argentina; united states; france
vagococcus fluvialis	Bacteria	4	lithuania; japan; egypt; india
varibaculum cambriense	Bacteria	2	united kingdom; switzerland
variola virus	Virus	18	brazil; belgium; united states; united kingdom; nigeria; democratic republic of the congo; bangladesh; benin; sierra leone; pakistan; china; indonesia; afghanistan; somalia; tanzania; india; ethiopia; japan
variovorax paradoxus	Bacteria	10	denmark; germany; france; netherlands; united kingdom; united states; russia; china; italy; japan
veillonella atypica	Bacteria	1	united kingdom
veillonella parvula	Bacteria	2	denmark; new zealand
venezuelan equine encephalitis virus	Virus	12	united states; venezuela; argentina; brazil; colombia; peru; panama; bolivia; trinidad and tobago; mexico; ecuador; guatemala
verrallina lugubris	Arthropod	1	india
verticillium leptobactrum	Fungi	1	brazil
vesicular exanthema of swine virus	Virus	3	france; japan; united states
vibrio alginolyticus	Bacteria	13	india; taiwan; kuwait; philippines; mexico; colombia; portugal; china; france; morocco; cuba; australia; japan
vibrio cholerae	Bacteria	40	iran; india; vietnam; china; guam; bangladesh; south korea; argentina; russia; tanzania; france; malaysia; brazil; united states; south africa; djibouti; malta; laos; hong kong; peru; haiti; mexico; kenya; indonesia; cameroon; italy; australia; micronesia; guinea-bissau; senegal; nigeria; spain; singapore; pakistan; thailand; taiwan; guatemala; united kingdom; democratic republic of the congo; maldives
vibrio fluvialis	Bacteria	3	china; india; japan
vibrio furnissii	Bacteria	1	japan
vibrio mimicus	Bacteria	6	india; japan; brazil; united states; bangladesh; china
vibrio parahaemolyticus	Bacteria	23	bangladesh; india; angola; chile; taiwan; kuwait; mexico; thailand; bahamas; malaysia; united states; china; hong kong; singapore; cuba; slovenia; japan; vietnam; spain; togo; nigeria; maldives; canada
vibrio vulnificus	Bacteria	6	japan; united states; china; india; hong kong; taiwan
vittaforma corneae	Fungi	2	india; china
weeksella virosa	Bacteria	1	united states
weissella cibaria	Bacteria	8	china; south korea; taiwan; thailand; japan; spain; italy; malaysia
weissella confusa	Bacteria	7	kenya; china; ghana; south korea; italy; spain; taiwan
west nile virus	Virus	36	ethiopia; cyprus; israel; uganda; romania; argentina; mexico; united states; malaysia; china; australia; russia; canada; italy; greece; egypt; madagascar; democratic republic of the congo; hungary; puerto rico; senegal; france; india; czech republic; spain; tajikistan; morocco; south africa; central african republic; nigeria; azerbaijan; portugal; kenya; ecuador; maldives; french polynesia
wickerhamomyces anomalus	Fungi	13	india; brazil; taiwan; belgium; myanmar; italy; russia; turkey; thailand; china; australia; spain; indonesia
williamsia serinedens	Bacteria	2	united states; taiwan
wohlfahrtia nuba	Arthropod	1	iran
wuchereria bancrofti	Helminth	20	iran; india; ghana; france; brazil; kenya; maldives; china; tanzania; taiwan; sri lanka; papua new guinea; french polynesia; philippines; trinidad and tobago; haiti; samoa; solomon islands; american samoa; togo
wyeomyia virus	Virus	1	colombia
xanthomonas campestris	Bacteria	29	kenya; democratic republic of the congo; south africa; france; panama; united states; madagascar; new zealand; greece; papua new guinea; tanzania; china; thailand; taiwan; zambia; jamaica; united kingdom; uganda; portugal; russia; canada; rwanda; italy; namibia; zimbabwe; brazil; nepal; mauritius; spain
yarrowia lipolytica	Fungi	6	germany; france; united states; cameroon; india; russia
yellow fever virus	Virus	25	central african republic; ethiopia; uganda; china; angola; argentina; trinidad and tobago; sudan; brazil; peru; democratic republic of the congo; ecuador; french guiana; senegal; guinea-bissau; ivory coast; colombia; nigeria; cameroon; kenya; spain; gambia; burkina faso; guinea; bolivia
yersinia aleksiciae	Bacteria	4	australia; japan; canada; finland
yersinia enterocolitica	Bacteria	13	india; germany; united kingdom; united states; finland; spain; france; japan; belgium; canada; italy; argentina; norway
yersinia frederiksenii	Bacteria	2	india; belgium
yersinia intermedia	Bacteria	3	india; china; hungary
yersinia kristensenii	Bacteria	2	germany; antarctica
yersinia pestis	Bacteria	26	kenya; democratic republic of the congo; madagascar; india; tajikistan; japan; netherlands; united kingdom; bolivia; russia; united states; china; georgia; republic of the congo; mongolia; kazakhstan; israel; armenia; peru; indonesia; kyrgyzstan; france; vietnam; brazil; hong kong; maldives
yersinia pseudotuberculosis	Bacteria	8	japan; argentina; united kingdom; germany; italy; france; russia; spain
yersinia ruckeri	Bacteria	5	india; china; finland; chile; spain
yokenella regensburgei	Bacteria	2	germany; india
zaire ebolavirus	Virus	5	china; gabon; russia; democratic republic of the congo; republic of the congo
zika virus	Virus	1	uganda
